raunt	Allah
ortet	irren
Zucht	ernte
quitt	juckt
Ellen	brate
Hagen	beide
Kunst	laste
Haags	Trupp
rapid	loser
Dusel	ordne
reise	Blitz
gelbe	Kulis
Beete	kling
irrst	kappa
Joule	Ortes
Lauch	Bocks
Pools	Lette
hopse	zugab
Pizza	David
Balte	Bords
Sepps	Blume
rasen	Enkel
Tokio	Semit
sehne	huste
drein	halte
tupfe	senkt
herab	Radon
Scham	fiese
ackre	Euros
Dunst	motzt
jault	kalte
dumpf	Abgas
Harem	Wonne
Seher	klaue
Bleis	kante
ekeln	Lochs
Venen	Cadiz
diese	ritte
linkt	Dungs
EPROM	warum
Erbes	Saudi
creme	Piezo
Hunde	UNITA
reihe	batet
Birke	Unruh
Limos	Drama
Wahns	lauem
Eggen	Posen
Tabak	Safte
Halde	Tarif
heize	flott
Bahre	Typen
webte	ehren
Kaufs	Krise
facto	ihren
pauke	Nixen
Zaume	Danks
pelle	Start
Ingos	sinne
Pacht	feure
Opern	legal
Steve	tauft
basal	Athen
Marge	liebe
Lacke	kugle
Zelle	eitre
zogen	haute
Tonen	rotes
losen	facht
Adria	berge
beweg	Felix
Spurt	warft
fahre	Adams
pellt	nimmt
erbat	maule
zahme	heule
Dalai	Sudan
lauer	hacke
Bosch	Saums
holst	Staub
wurmt	Torte
Wadis	Arena
Kabel	Media
Sorte	brach
Wachs	Verbs
einte	guter
Siele	Atoms
Futur	nerve
ahmte	glitt
trogt	Colts
eifre	Lumen
Pfund	linde
wiege	helft
flogt	hinge
sulze	Monte
einem	fiele
eilen	Titan
Tiefs	Simse
Pylon	Brote
Korea	Anode
