cacatga	actccca	5
tgttcacgga	cataccgc	6
atcaggcaacgtac	agaccttgtgaa	9
tgggctcccc	ccgcctta	7
tttacaatgtccgttcc	gacccgtccctacag	10
gtggactcggtccg	tgctcgcccaccggtcca	8
cgcca	tcca	2
aagcccgt	catccac	5
caggacttgactaattg	agcgtctcttatcggagtcg	10
tgttgggttcatattttcag	gactcgcacgatattcac	11
aaat	tcc	4
gtatgcacagcg	cgcagtccggctg	7
tcactcgctgt	ccatcggcat	5
tgacgtacttcatgcgtcc	tggacactgacgccgtggggagaga	14
gctgtaagggggccttat	gaggaggcagcatta	8
tatcgcgtttgctagc	tactctggcggga	8
tgctggcccaagctaaa	tagtagtatctcgccgaa	10
gtggc	ctc	3
cggtcgcctt	aatagctg	6
gatctgcaacgtaggggtg	tacccgcagttaagggtt	8
ctatgatgattgtttcgta	ttcccttggtgatgtcag	12
taattag	taca	4
tatctgaaatgcattacgt	atttgcaggtgttccactgcgct	11
acaagctctgggaactgact	gtgactaattcaatgtaagcg	14
ttcaagctttgagg	caatcgtaacatgtg	9
ccaaaaac	cccggct	6
aggcgccccaaccgg	aagatcgctgaccag	7
gagctctgagtagcacc	tggaccgtggagtgggaaa	10
gttggtact	aatgaatggatg	8
aacccgtaccggg	aggtgagtacgt	8
aatgcgtacttgtaaaaa	gagagtcaggatcgctgt	13
ccattcatgt	aagagtgaggt	6
ctagtctg	ccaaggttctg	4
gtaccactgctcggta	ggtcttgagattgt	10
ggaaaggatagc	aaggtatccccgt	9
ccggcctatggaatt	cgccaccacagtgagta	9
acctcttcccgaaca	tcaccgctcgagtg	9
gaacatccaaagtt	atgcctcccatggg	8
gtcctgctt	ataccctgca	5
agccatcg	ccgct	5
acaggc	tcaca	4
cccggaaacgga	tggatatgga	5
acgggagcagtctcctta	cttctgatcctagctt	11
tgacatgcaaaaagatctta	ttgcctagccattcaagccgtaa	12
caacggga	aaggcgtgg	5
aaccaagg	cacaacagat	5
atggtcttccatccggttc	ttcagcttgattcctgtcctt	11
gcatctt	gacatatgg	4
aagtaac	tatacc	3
tgcgggctagacgcctac	taaaaggtaggcgacacgg	10
gatggccactgtctc	gcgcccattttttc	6
catatcttccgga	accttacaac	8
ctattagtcgtatgacg	gagcaatcgagatagcacgtg	11
tattggatgcacgtcta	acttcatctttgg	11
gatacatg	actctgatt	6
ttcgtttgtctaaa	caggtggtatgcga	9
ggctcccatgtggggaggta	gctgggatttcggcgcgcttttc	13
cccc	atgca	4
tccaatctgaatgggtga	acctgattgcatctataga	9
tttatgaataacgtgt	gaagtagtccagat	11
taagcttatctaaa	ggagattgctt	8
acacctcagggtt	tgacctaactgt	6
cgccctcgaagtacaag	tccgcttcagtgaagctca	11
cccatgccacgtcat	acgagatccga	9
cgggaag	ccgaga	4
taccg	ccag	3
gcctca	tgtg	5
tgtcgtcgtcccctccgt	tactggcactaatcg	11
gaccct	aattctt	4
ccgatcg	ataacg	4
tcaatccctag	ttgcccacgtgt	8
tcggccaagactca	tcacaggagc	7
taatggccggttcgtcgttg	cgttgtcctacttcactactgtt	12
tgacggcgtgcaaaagaac	gttggactgtccaaatggac	8
atagagatagca	agcccaaatcgtg	8
ggccagtaatgg	tccttctgggaagcta	11
accatgaatattagct	agatctttactctgat	9
cccatacgactgttattcaa	acccatttaaaacccgcagtccg	12
gttaggaatgcgatagt	gatggcgagaacaat	9
aggacatga	tgccgcaaa	6
cagcccggtatttcgtcag	catgcctactgaccgtcag	8
agtggggcg	ggtgggcga	3
atacaactacatt	acctaagacta	7
ccccagcacagaatctagca	cgtaacaagggattgcaatt	12
ggaaacaaacccacagcaac	gatcggctccaggatgc	11
gcttgcc	ccccgcc	3
tgagaaatttgag	cgactaaaggtgtagg	7
ggcatc	ctaccgc	5
agtg	tcc	4
ctgttttatgacagtgctg	gctcttttggatgta	9
caccttggaggaagcgga	aaccccagagaaaacaaga	8
tagcatccgatccctgaa	ggaaaacggcacgggacat	12
cgacatccccg	tgtatctg	6
tgcttccatggacaatactt	gcgagtcgcatagctccca	12
tttc	catta	3
ttcgc	tccggc	2
ttagcgagattgat	caataattaaggcca	12
tcattaatg	tcaaaaat	3
ctacgcct	gcctgt	6
cctctccgggacagctaat	ggatttggagtgagtac	12
