# compare 1000 pairs of substrings from file ecoli.plain
CAGCGCCAGAAACGGCAGAGCCAGCACGCCGATGGCAAATCCC	GCATACTTTTCCTGATTAAGATTTTGCCAAATATGCTAGCCATTGTT	29
CGAGTTAAATGTTGCACAGGGGCAAGAGATGATTGCTCAACGGGG	CCCTGCCAGGCGATGCGCCCGTCGGCGACTACTACCGAGCGCGTGGCGAT	30
AAAGCGGCGATTGCGCAATT	GCCATTATTGCTCTACTTCC	12
CCACCCGAT	CCAAGCATGACAGT	7
CTCAGTATGTTAGGGTAGAAAAAAGTGACT	CTGTACTTCTCCCGGGAGTTGTTCAACAGATAT	18
ATTCGCTGGTACGCCGAAGCGATCGACAAAGTGTATGG	ATTGCGGGTGTTACCGATGTGCGTACTGTCCCGTGGAT	19
ATCTTTCGATCATGCGCGATTAAAGGTGAATATGCTAACCAAT	CTGTTGTTGCTAACACCGTTAAAGGCGGCGACGGCAACTACGGTTACAA	25
G	GCTGCC	5
GTGGGAATTGAACT	GCCGGGCCGAGGATTTG	10
CACGTATGTCGAAGAGATAACCGATTACGTG	GGTACGGTCAGCTGCACCATAAGCACCAACGATACCAAA	21
TCTTCTTT	TTTCGATGGCC	7
GATTGTTTTAGTCAGCGACCGCAATATGCAATCGTTAG	ATGACGTAGAGCGAGTTTATGGCAAGCCGTTTGCCGATGTGGC	24
GCGTGTGTGACCAGTTGCTGTTTATGGGCGAGG	AGTGCTGAAAAAACGTATTCGCTTGCAAGGTTTTATTATCGC	24
TTGCTGGCGGTAAGTATTCCCCCCCTCGCGCCATGGTGGATGGTCGTG	ATAAGCTGCGAAGTTAAGATGATCCCTAATAAGCTGGAAGGGCGGGGATGCCA	28
GG	TGAT	3
ATT	CAGTTG	3
TCAGGCCGTTATGCACTGCGTGCGC	CATTCAGGAAATGCATATGCTGACGGT	13
CACATGTGTTATTGCGAGTTCAACGACATCATGG	TTTTTCGCGTCAGCACACAATTCCATATTATTGGTGGTAGATA	27
CTGCCAATCATATAAACCT	TCTTTAACGCTCGCGGTCAGGT	15
CGGCGGTTGGTCATTCGTCCTGGGTTTTCTACGC	TCCATCAGCTTATACGGATTGGTCTGGTCTGCCGCGGTT	21
CCCTGATAGAACGCTGGATG	CGTAATCGGTATCAATAAGCATAACTTT	17
TAAAATCGAAGAGAATTGACCGCCTTGTTCAAATAAATTGATTGATAT	AACTTAATTCGTAAGTCAACAATCGGCACAATAACGCCGCGCAGATTCGTGAC	31
CATCTGCCCCACTTCGCCAGAGATATCAGTCCACGGTGTGGTCAAC	TTGGTATATTCCCAGTTCATCTTGCCGGTCAGGCGATAACTGAAGTAATCCGG	31
TTTCGATGCCAAAAATGGAGAGAACCAGCGCACAG	CCCCGCCTATCGCCAATAGCATAATCGCCAGCGTATAGC	19
GTACAGCCTGGGTGAAAGATGCAGA	AATCCACGATAAATGCTATCGCCGCGCCCACTT	21
G	A	1
TCCTGCGCGCTTT	GAACCCGCTCATGGCTCAGCAA	14
TGGGCTATTTCGTCACGGAATCGTCAGAACATTTTGCTGAG	CAGCGCGCTAACCTGCCGCTTTCGTACCCGATGACGGCGCGAC	24
CGCGCCAGGGGCGTT	GTACAGGCGAAGAATAC	11
A	AAA	2
TTTGGCATCAATATGACCATCACTTTTAGCGGCAAA	TCATAATTTACTTTTCTGTCGATGCAAAGAAATGGGCGTCA	24
ATGAGCTGTCATTGAAGATG	GGCGTAAAACCATTGCCCTGGA	15
ACCGGGTTGGATTCGCCCATACCACGTGCGGAGATCTTGTCTGCCG	GCCATTTGTTATCCAGACCTTTCTCGCGAGCCGCCTCTGCCGCCAGC	23
TGAAACGCTTCCAGGAACTGACGAAGCGCCTT	CCCCGCCGCTTTCATCTGCTCTTTCACCTGTGGCATCGT	22
ATATGCAGCAGCCAGTTGTTGAT	CAAATTACTGGCTGCCGTCAACCAGACGCTGG	17
GAATACGAGTAATCATTTAAATAT	CACCAGCAATACATCATAAAATCACAAAAA	15
GAATGGCCGTGGAGCACCACGCA	TCATGAATATACGCCGCTGATGGATTCTTCA	17
CGGGCGATGTTGGCGAAAACCCTTGCTGCGCTAACGCCCGGT	GCTTTAGTGCCGCGCGCAGAGAAAGTTAAAATTCGCGCCCTTGACCGC	28
AACAATTACGGGCCGCCTCCAGGAAGCGC	TTGATGAAGCTGATAACATTGAGGTAATCCGCAAATTG	24
CGT	TACGCGACT	6
CACCAGCGGACGCCAGTTG	TCTACCGGAAAGGTTATCG	11
TACT	CACCCG	4
CTGGATAACGGTCGTCGCG	TTCTGCGTACCAACCTGGCCT	12
GCCCTCTGGAATG	TGGCAGGGGCAGTGG	9
ACTTCAC	CATGTAACTGGC	8
CGAGCAAATAGAAAATGCCTGCAACGGCAGCGGCCAGCCAACGT	GTGATGTGGCCATCAGCTGTTGCTGTAAGGTGAGCGGTGATGTGCAGCAA	26
GATGTAAAAATGGGTCTGGAAATGAACTTTTCAAGCCTTATCAG	AAAGCCCTTAAGTTTCGAGCCGCCTCACATTTTTTTATATTTCC	28
GGCATAAGCCAGC	TCCTGATTTTCCTGATGAGAA	14
GGTGGTTTGGCCTCGCGAG	GACGAACATATCCGCGCCCG	11
ACGCACAGACAGCTTGCAGATGATCGGC	TTTATGGCAGATAACAAACCAGAGCTACAGC	16
CGGCAATCCAGAAAATCG	AGAACCTATGCGTGGGCCGCGTCGGGC	18
TGCTTTGCCTTTGTCTGAGTTGATACTGGCTTTGGTTCATAAACAGGCAG	TACCGGCTTCTTCGGTCATGGTCAGCAGCACTTCCAGCGGGCCGTGAACCACGTTT	29
TGGAAGGTTCTCGTTTCAT	GACCTACTGCGAATTAATCTT	12
TGGCGTCGGCGGTGTTCCTGCTGGCCTTTTT	TACAAGTGCGGAAATCATCGCCCGCATTATATAAC	19
TTGAAGCCGAACAGTCGCTGATCA	CCAGTTCAATGGCGGATGTCTTTAAA	15
A	CCAGAA	5
ATGTCGATAACGACGAAGAAACGCGCAAAATTCTGAG	TACCACGCGAAAAGCAGGTTGCTGATTGGCGATAAGTTC	24
CCGTCGCGCCAACAGTGAAATGGCCAGCTGGCTGGAG	GCGGGGCCGACGTCCGCGTAGCCATGACCGAAGCGGCAAAAGCCT	23
CTTATGTGAGGAA	CTTCGTCCGGGCGACC	8
TTATCGGTACCGTG	ACCGTTGATGGCCCGTCTCACA	14
GCCTGCGCGTAGTGC	CAGCAAACCTAAGCCGCGAA	13
ACGACTGAGTGTGCTGACCCAGGGGCAAGCGGGTAAGGGCAA	TTATCAACTGGCGCAACTTCCCGTTTCGGCGCTGCAAATGCC	24
TCGTCCCTTTTTACCAACCTGTGGTAAATGGTCGGGAAGGGACATT	CTTACGATATATCAAAAATGATTAACCATTTATTAATTGATGTTATTGT	30
CTGAAATTCAGGA	CCGAAAATATCCCTGGCGGG	10
GTGCCAGAGAAGTTATCGTCATAAAAGTGCTGCCAGACACCGTAAA	TTCTTGCGGATACTGCGTATACGGCCCAACAACTCACCATCCTGCTGGAAA	26
TCAGAAAAAGTGCTCCAG	AACCCCGGTATTCGTTTTA	14
ATGCCCGTGGTTATGTC	CAACATCAAAAACTGCT	14
GTAT	TAGCCCA	6
TAAAGTCGGTTCCCGGTAACAACAAC	CGCCCCAGCGTCGCCATAGTGCGTTCACCGAATAC	21
TACCGCAATCATCACCATTGCACCACTGCCGGAAGTCCAGC	AGTGGCTTGATCATTAAAGCTCAGGGCCATATTGTGGCGGGTCAAACA	26
TTACGACGTCCGGCCTCCTGGCGTTTCTCCTGTGCCAGTACCT	GCCTGCCAGCCATAGCGAAACCAGTGACAAAGCCGCAATGCGGCGAACGGTG	32
GGCGACCAGGTGCTCTATCTGTGCGGG	CGACCAAATGCAGCGTTCTCAAAAATGATCAGA	17
CGATATCGCCTTTGCTCAATGCTTCGTTTG	AGAGCGTTATAACCCGGCACAGTGGAATATTTACGCTGC	22
GGCCTCTCACAACCGG	CTTTGTGGATAATCGCCATTCCG	14
ATCCCTGAGTTTATTGGT	ATTTGTAGGTGATCCCGGTAGAAATCA	17
CTGCCCGGTCGTGGACGTAACCACCAGAACATACTTATCCTG	CTGTGCTTCAGCCGCCTGTTTGGCATTAAAACGCGCAAACTGGAATGGG	27
TGGTGCG	GTAGGGTGGAATCTAA	10
GTAATGGGTATTTATGACGG	GCTACAATATGCCGGTGATCGCTGAAGC	13
CCTGAA	AGGGAATGATCCC	10
ATTTTGCTCTTCCGGTAACAGAAGTACATGCGCAGCGTTGT	GTCGTTCCAGTTGATAGCTTTCATTTTCACCAGGTCAACAACACC	29
CATTACCCTCTGCGCTGG	GCAGGTGGTTCTGGATCA	11
AAGCTTCCGGAGAGAGGCCCGCATCAGCGATTGCCT	TAAGTAATAAGCCCTATTTGGGGAATATGTTAAATGATTTTG	27
AATCCACACAGTGACTTACCCTGCGCAACGGAAGATGCC	CTCAGTTGGATAGAGCAACGACCTTCTAAGTCGTGGGCCGCA	25
CGGAGATGATAAACACCACCAGGATGTGGAATTTCACGT	TCAGGTGACTGCCAACGTACTAGTGCTTCCAGACTGCGCACTTCGCCA	24
CA	CA	0
AGTGACC	CTCTTCCAG	7
ATGCACCCGAC	AGAAATGTCTGAATATCA	12
TCGCCAGCATCAATT	CACCTGACCCCATGCCGAA	12
ACGCCACGCCATCTTCAAGGTT	CCTGGGCGACGCTCAGGCCTACTTCGTCGAT	15
CGCGCGCGTTCAACTGGT	TGTAGCTGCGACCATGACGAAT	11
GCTGGCAGCGAATGAACTGGGGAAAGATA	AGGATAATGCGTATCGTACAGCGCCTGCGGGAAGCCAC	20
TCATGATGGTGACCACCGCCGCAGTAAAT	ATGTTCCGGTGATCGTTCAGGATAAGAAATT	16
CTGACCACGATACAGAACGACAGAACCC	TATAATTTTGCATTTCGCTATTTCCGCACT	20
ATGGATTTTT	TGCGCAAAGGTATGCCA	12
TGTGTTATAACGGTTTTAACCT	TGAGCAGAGCCGTGGTATCGATCAGGTTG	17
GACGTGCTGC	GCTTGGTCCAGCTCGCT	9
ACGTACAGTGACACAGGTTAATTACCGTGTTGGT	TGCAGCGCGTATTATCGAACAGATGGAAGCGCAGGGGA	22
CGGCA	CCTGG	4
GAAGCACATTGCCGGATGCGACGCTTGCCACGTCTTATCCGGCCT	TCAAACTCCGCCAGCAGTTCAGCGTTGCCGACGCCGGAGCGTTGC	24
GGTACCATCTGCCAGC	CTGAGTAATCGGTATTA	11
TGGCGAAGCAGTCCGTATTCGA	CCGGTTATTATTATTTTTGACACCAGACC	19
ATCTGCCAGCAAACCTTTGCGG	CCTGCGCCGGACTGCCGCCCAGT	14
TAGCTGGTATTTT	CCGTGTATGTGCCA	9
GCCTGAAACAGGCTGAGTTCCTGAATGATGCCTATGATGATG	ACCACGCATGGTGATCGACGATGCCAGCCGCGGATCGAAGAAGCGGCAGGC	29
AAGAGGGCCTTTTGGATCGGGTATTTAGAT	AGATGACTTTATAACCTTGCTCACCCCAGTGTTG	20
AACCACAGGTCATATTAGCCAGGCACTTCATTATCTCA	CAGCGGAAGATGTTCGTGGGGCGCTGGCGCTGGTCGAAC	22
CTGGATGCTTGACTA	ATCGCCCTGGGGGGCAC	11
TCATGCCGCGCTCAACAATCTCTTCTTCGGTCTTACATTTAC	GCCAGTTCTTTCGCAAACGTTGGGCCAGAGATAACCGCCAGC	27
TTCTCCGGCCCGACGTGGATGG	AGACAATCACCTCGTGCTCGCGC	15
TGGCTG	TCAACTCCGAAA	8
TTTGCCGACCCACCATATAACATCGGTA	CTAGCCCGCGCGATGAATGGCGTTGGCCTGAAGAA	20
TTGCCGCTATTTGCAGAAGAAACGGT	TGGGTAGTGACTACGTGGTGAAATCCAGCGTCGGT	19
GTCACTGCCCGGCTGTATGCGCGAG	GTCAGGTTAGGTTCCGGTGCCGGCCCC	15
TTAAGAGGTGGGCAAGACGCTGTTAGATTGGCAATTGAGTTCTGC	CTGTGAAAAAGATGCAATCTATCGTACTCGCACTTTCCCTGGTTCT	26
GTTCACGAACCAAGTCAGGCACAGCCCGTTGCTGATGTCGTGGATGTGAT	TCACTTCCGGGCGGGTGTCGAATGCACGCACAATCGCGCCGAGACTGTTTGCTGCGCC	31
GAATCGATGTGAAAG	GCGATAATGAACGGT	8
TTGTTTTACGTGATTCTGCCTGCAGGGATTCTGCTTCTGCGATTTTTAC	TACATTCCGGGATCGATCGCGCTACTCGTCTGGTTGATCAACTGCTCACGCT	29
TGTTCAGTGCTCACCCCCCAGAGTATAGCTCATTCCATTATTCAACT	TTCACGTTGGATCGCATAATGCCTGCAGCAGGAGCACGGATCACCCGTCGGGTGGT	32
TTGTCATTTGCTTATGCCTTGAAAAAAGCCGAAGGTGAAAAGACACTTC	GCGCCAACACCCAGGACACGGTTATCCATGCGCTGCGCGATATCATCAAACAC	32
CTTTTCCGGTACCAGGCAGCAAAAATGTGGCTTCGTCTCA	GAGCATCAAGGCTGGCAGCGGGTTCATCCAACAGTAATAGCGAACAGGG	30
AATGCCAATATTATGTCGTTGGGTGGCATTGCGATTGCCGTCGGGGC	AGGTAGTAGCCCGGTGCCGCTTTCGCGCCGAAGAGGAAGACGCGCGGTACG	30
A	ACTG	3
TTCGCTGCGCAGCCTTAACCCGCTTTCC	CGCGGAGTTTGATTTTCGACGTTGGCAAGCTGA	22
TAATTG	AGCTGTTCGTC	8
TTATACCGTTATCGTGCTGATC	GTTGTTGGGGCTGGAAGGGGAAGG	16
AGACGCGAAGCGCGCAATGGACGTTTACTGC	AATCGTCAGGAAATTGTGTCAGCGAATTGCCGAGAAATAT	20
TGAGGAGAT	GGTAGTTCGG	7
TCGGTTACATTACCTTG	TTTAACAGATTCAACACCCGTTG	11
GCGGTTAAGGTGCCTCTTGTGCGCCAGAAGTGCATATAAACGATAACA	CGTTTCTTCTTCCGCCATGCCGGGTTCCCATTTACGGGTTGTATGGGTAT	31
CCCAAACCGAACAAAAGCGATGATGAAACGCGGGCGAACGATG	CGCAGAACAGCTCCGGCAGCGTCATCACCGCCACAGTCGTTGAT	23
GCGTCAGGTAATTCAGGCCGACGTTAACGAGGAA	TGCGGATGAGAAATTCGCTGCTCTGGAAGCCGCAGGCGTGA	21
CGACGAAAAT	ATGCATCGTATC	8
GAATTGAAAATTAGCGTGTAATCTGGCGTCGGTC	CATCCTGACTCAGTGGCTGCTGACCAGCTACTCGGCGCGGAAA	22
TCTGAAAAATCTGCCGGAAATAGCCAACGTCATTAAACCG	TATTGTGGTTTCAGGGATAAACAAATCATTTAACGCATCTTCCAGA	26
GGTGAT	ACCAGCA	6
TCATCCCGCGAACTCAGGCTACG	GGCTTTTTTCCCTGGTTCTGCTGCCCGC	17
GCAAGATCGGTGCCGCCACGAAACTGCTGGCTTAAAAAACGG	TTCGTCCAGCTGACTGGCTTTCGCACGAATGCGTGCTTCCAGCTGGTC	25
CTGGTGTTCTCAATATTTGTCATTGCAGCCCTGGCGCAATATT	GTTTCATAACGCCCATCCACCAGCCATGCCATCCCGGCGGCGGCC	27
CCGGAAGTAAATAAGATACGTA	AGAAGCTTCCGAGCAACGTTTCGAC	15
ATGTTCTACAAAATGAGCCACGCCGAG	GGGTGATAATAATATTCCCATCAGTATCACTATTT	20
TGGGATATCCCCGACGGTTTTCTCTGCCCACCAGTACCGGGCCGGGCGG	TTGTGTTACCCAATAAGGAACGACTCTCTTTGTTCGAAAATCAAACAAAAAAT	33
CGGTAAAAAACCGCGCCATTCATAA	TTTTGTGGAATACCTTGTTTCAGGGC	16
TACGCTGGAAAACGTCAATAAAT	CGAATAATTCACCGTTCAGATAGATATCA	16
CACTAAG	AGTCTCC	6
GAGCAGAAACTAACCATCTGTACGCCATACTTC	GCGCTGAAACTGGACGCTGACTGGATTGGCTTGCTGGGCGCG	20
CGCCAGCGTGTAGAGGAACGGTGCGAATGGTTGGCTAAGGGTA	ACCGCGGTGAAATACACCTACACGGTGATCCCGGCGCTGGTGA	24
CAGCTTCCTCAAATTCTGCCAACTGC	TGTCCGGCAAGATCTTCATATAACATGCCAAC	17
CAGG	TATGCGTTCT	7
TAAAAACGGTCTGTTAAGC	GATGGCCGTCGCAAGCTAATCA	13
ATCAGTCAGCGCAGTGACATTCACCTCACGACGCAATGGATCAA	GATATTTTCGCCCAACGTGCGCGTACCCATGAGGGTAAGTTGCA	24
GCGTCCAATTTGTTTGGCGATATCCTTTCCGATCTTGGC	TGCCGTCACATTTATGGTTGGCACACGTACCGCAATCGCTTCAAAGC	20
CAGATCATGTTGTTCAGGCCGATTGTGAC	GTCGTCGTGTTCCCGGAAGGGAAGAAGATGTGGG	19
TCCGACGATCTGGTG	GTTAAGTAGAATCCGCGGC	11
C	TCCTGC	5
GCCCATTTCTCTTTTGCTTCCCCCATCGACACCCACACATCGGTATA	GCTAACGACATCGACGTACCGGCTGCGCTGATCGACAGCGAAATCGACGTTCTG	26
GCGGCGTTGTTTTCCTACATTTTCCCATCCTGATAATCGCCGC	TTTCCGTTGCCCGTACTTGACGGGGGGCATCTGCTGTTCCTTGCGA	26
CGTTTGGGGTAATCACCGCGC	ATCAGGCGGTGAAAGCCGATTGTG	14
GCCATGCATTGTTGCGCGCTCTGCCAGTCCCAG	CCGGCATCGGCTGAGACAAATTGCTCCTCTCCATGCAGC	20
CGGTCATTACGCACCCGCCTTCTCGTTCAGTAAAGTCTTAACGCG	GACCTATGTAAATCGCCATCCGCATATGAACATAACCGCTTTGAC	25
AGCCTTCTTGCTCCATTCGT	ACGACCAATACGCTGCTCCAGTAGATC	11
AGTGCG	CATCCAGCGTG	7
AAGGACGTTTCGATACGTATCCAAAACGTCGCGGCATCA	GTTTGTAGATGGAAGGTAGCACTTCTGCTAATGGCGCGTCGGA	25
ACCGGTGGTGACTCCCATACCCGTTTCCCGATCGGTATCTC	TACAGGCGATGCCTACAGCTTTAACTGGTCAATGCGCATTGC	22
TTTATTACGATCGACACAAATCAGCGCA	ACCATTTTCACGGCGGCATCGGTCAGATCGCG	16
AACACC	GCAGGTAACG	7
ACAGCAGAGACGCTGAACGGCTGGACCGATTTGC	ACGCCACGTTATATTCCGGGCGCTGATGTAAGCC	19
GGGAAGCCCTTTTAC	CCAGATCTTCGCCATCATGATCTC	15
GCCTGCGGCAGAATAATC	GCTTATTTTTTACGCGTAATA	12
GGTGGCTTTCCAGCGGCTGA	TACCACCTGGCTGGTGTTCTCGGCG	15
CATGACCAGTAGCGTG	GGTGTTCTGAGCATCAGT	10
CCTATGATCCCGAACCCATTGGCAGATACAACGTCG	CCGCCGCCGTTCAGCCCGGTACAACTTATTGAACTGCATGTTCTC	26
CTTCAAAAGCGATGCGGTAG	ATAATCACGCCCCGGCGCTTCCAGTC	16
TCGGATTCGGTAATCGCTCATGCTCACCTTT	GCTCGGTGCCTGAGTCGCGTAGCCAAATCATTT	16
CCCTTTGGGGAGA	AGATCGCGGCGGCGTAAC	11
AAGGCGGCGGTAAA	CTGTGGAAAATAGTGAGT	13
CGGTTCCACCTGCGAACTGGATAGCCAGGCAGG	GCGCTGCATGCATTTGAAATTACCATCCCGCCTCTGC	21
TATGTCCCCGG	AAATGGTTGCTAA	8
AGATTTGCGATAGCGGAATTCAGAGGCGATTTCGACGT	ACGAATTTGAGCAATACTGACCGGTTGATAACCGTTCTCGCGCAG	21
CAGCGCCCGCATATAGCGAGCGGCCATACACCACTTCCA	GCGCGACCATCGCCACTGAAGAGGTGTTTTCAGTTCTGTTCGA	23
ACCCTC	CACGCTTTCGCAAC	9
CGCGCTGCAATTTTCAGCGCCAGTGCCATCGTATCCATCG	TCCAGCCGAAGGACATTACCTGGTCATAACGCGGACGCGGTA	25
TTACCGAACTAACCGGTAACCCGCGGCACGAC	TGCAGTTCCTGACGGGTGAATATCGTAACCCGCGTCTGTTT	21
GAATAATGTGTCTCGACAGGGGA	ATAGCGTTTAATCCCTTTGATGGTTTTGACGC	21
GAAGAAGCGATACCAATTTTTTATAAAACGGTACGTGAA	TGACGCGATCCATCTGCTGACACCACGCGCAGTGAACGAAGAG	22
AT	CCACAGT	5
TTC	GCCAGA	5
GGAAGTCAGCCAGTTCACTTTATTGATG	TCACGCGTTAATCCGCCCTGCTCAACAAACCACTGA	21
TGGTTTCAATATACTGGCGCGGCACGCCG	GCCGTTATAGCCGTAGGATTCCCTCGCAC	18
CGTTGAAAAGTGCATCGCCTGCGCCCGCGAAGTCAA	TTTAACCCTTTGCAGTGGGTTGTCGCTGCCTGACCTTTTTTGTTT	27
CTTCGGTCG	TTGGCGCAGCGTGC	9
AAATCAACCAGCGTGGCTTACGAAACACGCGTAATGGCGGCAACCTCTT	GACCTTCTTCGGCTCAACCGTCACCGTTTCTTTCATACGCGTATGTTCAACA	32
GCACCACCGGCGATGATACCGGTACCTTCGGAAGCCGGCTGCATGAATA	TAATGCAGCAGAAAATGGGGCGGAGAGCGCCGCCAGAGACACTTTCAAA	29
TCTTAACCGGGAGCAGGAACAGAGAATCTCCCGTATTACATTTTGAGGAA	CGTGGCGACCGGCTGATGATTATCAGCAACGGTGCTGCGCCTGCCGCGCTGGCGCTG	34
CGGCTTTGCTGGGTCAGCAGGCGCTTCCT	CGCTTGATGATGCAGCTGCAGCCATTGCAAAGC	17
TCGCGGTAAACATAAAATTCTGGTGATCGCCGCGGACG	CCAGCCAAAGCCATCCTGTAATGGATATTCGCCACCGCCGC	20
TCTGGCGGCGCGGGTTCCGTGCG	CCGCCCAAATTGAGGGGTCCATTAA	15
CCTACAGCAGCTACCGGACGAAGACGCCTGCACCGGTGGGCGTTTTCGG	GTGTATATACCCGAACATGGTGGCCCCGTGCGGCAACTGTTGATGCAATGCGCATAAA	35
CAGCGAACTGGATAACCAGCTAAACAGTTCACGG	GATGCGTTTTAACCGTATTTTCGCTGATGAACAACGAAC	21
TAATGTAGCGCGTGCGTATTGATGAAATTTTAATTTTACTGGTTT	CCCGTTGCCAGCGTCACGCCAAGGCCATTACCCACATTGCCTTGCGCGTTGTG	30
GTGACTCA	AGACGGCG	5
GCGCCCGGCGATAATATCTGAAATGCTTTTACGCGAG	GAGCCTCCTGTAGGGTTTTTATTAACAACGGCTTATTCTAATT	22
AGAAAGATCGATATTGCCGCCG	TAGCCATGGCAACCGCCGGGGTGGAA	17
CTTTCAAAATAACCTGTTTGAATCACAGAT	CGAAGCCGGATGTGGCGCTGAGCGCGCCCAGTCCGGC	24
ACCATGAAAGCACTGGAAA	GAGGCGATATCACGCTGAACATACC	14
ATCACATCGCCCGCCACCTGACCATCGCGCATAACGGTGGCACAGGAGGC	ACGTTCGATGGAATCGACCGGGATCCAGTTCAGATCGAAATCATTGTGGCGG	30
ATATACCCGAACATGGTGGCCCCGTGC	CGATTTGGATCAACGGAAATCCCGCCCCATTCG	17
AGCACTTAGCGCGGGAACACGTAC	ACCACGGCACCCACCAGCCACCACAAGT	16
AGCTGCTGGTCGAGTTTCAGAGTCTGGAA	GCGACGGGCTAATGGTCATCAGTGCCAATCCACTCT	21
CGCAGGTGTCGGTGAATCTTCTGAAAGCCTGGCGCGACGGGG	ATCCTTACCTTTAGATTGCAGGTAAGCAACGGACGGACGCAGAC	25
GGTTCAGCGACCATCGCGCT	CAACCGGGAAGCGGACCGCCACATCTTCT	17
ATAAAATCTAACTGGCGGTCAAAAAGATTATCGATAACGCCATTTT	ACAAAGAAATAGTTCACGCTTTGACCAAGTAACAGCCAGATAATCG	27
TGCGGGTTTCGAAA	TTTATTGCTGCTGGCAAC	11
GT	CTG	2
GTGATAAACCTTATACCTTGAGTACATGGAGAGAATAATCGCTTA	ATCCGTTCCCACTTTCATCGCACAGCGATCGTGAGCAACAAAAAACTGTTT	27
ACATACTCCTTGCCTTGCTGATCCCAGATTCG	ACGGATAAGATCGCGAAAGGTTCGACGCGTCCAGCCTTCGC	21
GCCGCTGCATGTACAGACTGACCGGGTAATTAAAGACTCCGGCC	CTCTGCAATCCACGGCAGATCGGCCATCAGATGGGAATCGTTGGCA	23
AGGTAAGGAAGAGGCGCACGGCGCACCACTGGGGGAAGAAGAAGTGGC	TAGCGTTAAGTGTCGGGTTAACTCTCTCGGCGTCATTTCAGGCCGTCG	29
GACGGGGCATCTTTACCACGAGCAATTG	AATATCCACTGGCACCGCGATGGGCGATGACTATT	20
TGCGGTGAT	GCAGCATTTCGCCG	10
CCCCGTTGGATC	GTAACACTTCCGC	10
ACGATTGCCATA	TTATCACCATCAC	7
TGCATCTTCAGACAGTTTATCCACGTTCGCCAG	GTCGATGTAAACAATACAGAAAGAGGATTATTAAGAACCA	24
GTTATCA	AGCTGATGGT	6
GTCAACCCCCGTTGTTGGCTCATCAAGGATCAACAGTTCCG	AGGCGTTCACGCCGAATCCGGCAGTTGTGCTCCGATGCCTGA	27
GGTCACCTGGGACATCATCCCCGACAATGA	GCCAGTCGATAATATTGACGCCACAGATTTTTTT	21
TCATACTCCGTTCTTCAAAGGCTACCGTCCGCAGT	ATCACATATTTATATTGTGAATAATTTATGTAAATAATGGCTTT	27
GC	CCGGGCCGC	7
ACAAGTCTATTTCGGA	GACAATATGGATTACTTTGCCAG	12
TTGGTACGCTTGATAATTGCCGCAT	AATAATGTTGTATCAACCACCATATCG	16
TGCGTTCTGGGACGAGCTGTTGAAAGTGCGT	GTGAACTGAGTTTCACCGCCAGCGCAATACA	20
CGAACA	GGACGCTCTGG	8
TTTGCACTTCGCTGATTACTTTGC	ACCAAGTAGTTTTTGTGTGTCTAACC	17
CGTCCCGAATGTATCCGCTCAC	GTAGTTGTTGGCCTGCTGCTGGG	15
TGCCGTTTGTGGCCGAA	AATTGCCATAGAGAATTGCACTAT	13
ATGAAGATAAAACCGTACCGCTTGCCGTTGAGCGCGTAC	TACCGGGGTTGCTGAGTGAATATATCGAACAGTCAGGTT	27
GGATGCAAA	GCATTTCGTTGTCGAGCT	12
AGAGCCTGG	AGCACCGTGTC	5
AGACATCCGCT	AGATGCCTCGCTT	5
GACAGCTCCCAGG	CTGTCAGAAATTACCC	11
AATGCTGGAATA	TGGATGGACTGGCAGAA	8
GGACTTCTTTCGTATT	AGCACTGTTGAAAGAT	10
CGGCTGTATCGGCAATCAGGACG	CCACATCGACCTGATCATCAAACTG	13
CCAGCATCAACAACATGGCGCTGTTTTCG	GCTTCTGGCATCAGGGTATGGTTGGTGTAAG	17
TGCGGTTTACGGCGCGGTAGCGGGC	GCGTTGAGCTAACCGGTACTAATGAAC	15
CAGGCGCTGGCAATACGACTGGCACGCCCGGTGGTAG	TGCATGGCGGCGTCTTTTACCGTCATACTTTGCGACCAC	23
TAAAATAAACGAATTATTTATTCGTTCACATTC	TATCGACAATATAATCGTTGGTCACCATGCGGC	17
GCAAAATGAAGCGGA	TATCTTGATGTGCTGCAT	11
GGGCAACAATCACGTTGAAGCCTTCCATCTCGAGCAGCTCCTTTAAT	TATTTTCGCCACTGAAACCTTGCGGATAGACTTCGAGGAACTGCGTTTTA	25
GGAAGAATCAAATTAGGTAAGGTGAATATGGGTAAAGCTCTTGTC	ACTTCCGGGTTGCTGGCAGCTTCGCCTTTCGGCGAAATGCTGTGGT	28
TGTTGCCGGTTATATGTCAAGAAGGTATCTATGGGTGAGATTAGTA	TGCTTTCAAAACACAATTATAAAAAATCCCGCCAACAATATAAGTTTTT	29
ACTGCCGCCAGA	TGACCGCCAAGCTGCCCTT	11
GCACTCG	GCCCGGATAGCGGTTG	10
GTGACAACGTGC	CTGCTTTTTCGG	8
TCCCCCTCTCTGGAACGGTAACTCTCA	GAAGAACGTGGCGATCTGGCGCGCGCTTCAT	19
CTTCATCTGACGGA	ATCCCCTCACCCAACGTGC	10
AATAC	AGTGCTGA	5
CAGGTTGCCGAGGCTGTTACGAATGGTTTTACGACGCTGGTTAAAG	CAATTGATGACCATTTCGAGGAGATCCTCGATATGGTCAAAATTGGCTCAAATGC	29
GAAAAAATACGCGACAGCGCGCAATAACCGTT	GAGCCCTTACACATCGTCACCGATCAGGCATTAAAT	20
CTG	TCCACTCTTCT	9
GATGCATACGCAAGAAATA	TAACGCGGTGGTGGCAATCAACGGC	15
AGGCCCTATGAATCGCTGGGAAAACATTCAGCTCACCC	TGTCATAGTTGTTCTGGTGGTTAGCGATATAGATAGCA	21
GCAACCTGCTTTGTGGCGATAAACAAACGGCGCAAACAT	CGCGGCAGATGGCGGCGAACAGAACGCAAATTATTGCTG	23
C	GGCAAACAT	8
AATCTTCTCG	TACCAACGGCGT	7
G	GAGG	3
TATCAGTGCCACT	ACGCGAAAATTGCGGTTATCAC	15
ATGTTCG	AAGCTTTCCAGTCGTA	10
AATCGACGCCGTCCAGCTCGCGGCAAAGG	ATTGCCATTGGGCTTGCCGGAATCATCATGCT	19
ACCGGGGGCAAAGGAGGTGTTTTTCACC	GAACATATTCGCCGCTCGCTGTCACCAGGGGGATT	26
GTCTTCGTTAACG	TGTTCCAGAACTACGCGTTGTA	14
ACAACACGGTCAGCGACAT	TGTACGACGGTTCCGTACAA	9
TTGCAGGTAACGATCAAAGAGGCTGACGGCAGCACGCAGATTTTTACCG	CGCCGTTGCAAACCGCAGCGCGAGTTGCAGCAACAGGATGCTGAAAGCCCGT	28
GATGTGTACATATCACC	GCCCAGTTCGTTGTAAAGAATGAA	13
ACGTATCGCCAGTGGAGGTTGAACCGGTGGTATCAAGGGTT	TCTTGATTCGTTGCTGGCCCATCTGGGAGATTAAAGTGAAAAAATTACG	29
ATAAGGGGTGAGGCTGGCATGTTCCGGGGAGC	GCACCCATCATATTTTGCTCAAGGGCGGGGAAAAAA	24
C	GACGATATGC	9
CACGGATTGTGCGCAGC	ACACTGAAGTTCAAAACACCGAAA	14
CTTCGCCCAGCTTCGCCATGTAGTCGT	GCTCACTAACTCTTCTCCAGCGGGAGACGGG	15
AATTTAAGCCTTGCGATCTGCACCCCTACTCCCTTT	ATTGTTTAGAAGGCTCAATGAATTGCAGGAACATCGG	23
GTGGTGTCGATTGGCTACCTGGTGAGTAAAATCGATAGCTGGCGGGCT	TTTGAAGACATCGTCGTCGAGCACCACTTTCTCTTTCAGCGCCTGCGCTAAACG	32
GGTGTTCCGTTGCCCTGTTAAAAGCGA	GCGCGATCGGGGCCACCGATGGCTTTGCATTGC	18
CGTCGTAGTCCGGATTGGAGTCTGCAACTCGACTCCATGAAG	TGATACCCGTGCGCTGGAAGAGGTCGGTCTGACCGAAGCCCAGGCA	24
TGCTCAATCAGTACAACGTAACGCTGATTGAA	TCCTGGCGAAACGCCCGACAATAACGTTTCAAATGCAGGA	19
AGAAGAATTTCCCCGC	GCAGAATCCATCGGCGATG	10
CCGCTTCGT	AGCAGAGATGCA	9
GATCTTTTTCCTGCTC	CACAGGGACTGGCGAACCGCTGTA	17
TTACAGGAGAA	ATCTCGTTCAGCGCCGATTC	12
AACCGAAACCAGTGCCGACTTAGCGTTACTGCTGGCG	TAGAGATTTTGTTTGCGGTGTCTGCCGCGACCACGCTT	24
CTTGGCGATCATAGCGAGCAAGGGAAAATTATGGGCT	AAATTTTCTCGCCATGAATTTCCAGATTTCCCTCAGGC	26
AACGGGATTTT	GCCGCGTTATTCTGT	7
GGAACGGCTCACGCTGTCGAGTAAATAGCGGCGCAGTTCGTCGCAGA	GAGGAAGTAGATGCAAATGGCAATGTCACACTAAACTTTTTTGCCAATTATCGAG	28
GCCCAGACCGTCTCAATGCTGCCAACAATCGTCGCTCCGACC	ATATCATTGAACGGTTGGTTGATTCTGGTGTATCCCAAGTCGTAGTAT	29
GCCGATGTGTCGCTGGATAAAG	AAAGACAGGTTAAATCAAACCTGGTA	18
CATCATCGGT	CCAGTCGCGCAT	6
CTGTTTATACAGCAT	GTTCTGCCCATGGAGAATT	10
AAAATAAGCACCGTAGATAAAACCGAGAGTGATAAT	CGGCAGATCAACAGAATCTTTATCCTGACGGAAGGCATTCA	24
TCGGATTACCTTCACGCAGCAAGTCGCGATAGTGTTTT	GCCGTCATCGTTATTGCTACTGGTCTGCCTGCTTACGCC	24
TCATGTAATGCAGGTCCACGACCAGCGCGAACGGCAGCATGA	AATGCTGTCCAGTTCCGCTTCGTTCGCTTCAGCAAACATCACCACATC	25
GGAGCCAGGTTATTAAG	CCTGAACCTCGACGTGTGC	13
GGTTGTTGATTCTCGTGCATAATTAGCGGTCCAC	TCAGGCAGCTCCAGCAGCAGATATTTAGCCCGCCGCTGCA	22
CACCAATCCGGTGTTGCAGCTCAACCTGG	GCCTGAGAGGCGGGTGTCTCTTCAAGCGT	16
AGATAGTGTAGTATGTTGCGCCTCAAAGCCAGGCCGATAAACGTCG	AATGCACTTGAACAGGCTGTCGCCAACGCCATTTTCCCGCAGGAAGATT	26
GAAGGCGCTGGCACGCAAAGGCGTTATTGAAATTGTTTCCGGCGCAT	TTTTGCCTTCGACCGTCCGGTTGAGTGGATGAATAACTGGACGCTCTTCTT	30
ACTTCGTGGATGGTTTTGCCTTTGTACTTA	CTGGCACGGGTAAAGAGCTGATTGCCCGTGC	19
CCGCTTTGAC	CTGTGTACGCTAGAAAA	11
GGAGCCGGAAACACAACGGGTTATCTACCTCCGCGAAGGTTA	GCGTCGCAGCCGTGGAACTGGCAAATCAATTTGTACCGGAATGCTATCAC	26
GTTCT	TCAATAA	6
ACTGTCTGGTATACCGCCAGCAATGCAGGGCGTTTTTACGG	GCACAGGCGCGTGGTTATCAGTTGGTGAGCGATGCTGCCTCACT	26
CCGGGGATTTGCATCAGCAAGTAGGCCCAGCCAAAAGCG	GATGTCGAAAATCGACAATATGCTCTCCACCAGTACCTC	23
GC	GACTC	3
TATCGACGAACT	GAGACAAAACCGCAGTAAC	12
GGTTG	CCGACTACCGAAC	10
TGGCGTC	TGTAGAGAAT	6
CCGTTCTGGCTGTAGCTGTCATCA	GGAAAATAATCGCCGCCCAGAAAACGCAT	20
GCTGGCGAATGCCGAGCGGCAATGACTC	AGAACTGTCAGACAAAGTCACCTTTAAAG	19
AAATTAAAATACATACCGAAATTCGTATAATTTCAGCA	AGGCGTCGGCTCCGGGTTTGGTGTTGGATCAGGTTTCACTTCCGGCA	28
TAGAGCTGAATCAGTCGCTGA	AAGACTATATTGATGAGTCTACCGGC	13
TGG	ATGGCAA	4
CTCTTCTTGCAGCGAGATTTTTTGCG	GCCATTTTAAAAAGCAGCAGTCTCGCT	15
CAAACTCAGCCGCCCGCCCGACGCCGGAAATAA	GGTGCGATGATTCTTTTAGCTGCCCTTGCCGCCTCCT	25
CGACGCAGAATGTCAGTTAC	ACACCGGGGCCGACAGCATTCTG	14
GAACCAAAATGTGGCGCAACCGAGAAACAACTCGCTATCTTTAATA	GTGACTAAGGCAACAGAAGATGAGAAGAACGCGCTCGCAAAATTAAAAGCA	26
GGTCACCGC	TAGGAAATATACTGA	9
GTCATCGG	GCTGATGGAAGCTTGTC	11
GTTAGGTTTTCACTGGTCTGGTAACGTCCGTTAC	TTTCCGGGCGCATTTGCGCTTCAAAGGCATAAGGG	22
AGCAATCTAAAAAAGGATAGCATAGGCAAGAACAGAGATAAGAAT	ACGCCGCCGAAGCTGTTGTTACGCAGTTGCAGATGTTTCACCACGCC	29
AT	GCT	2
ATCATGTCTCTCGTAT	CAGGGCGAGCAGATGGCGCG	15
CGCCGGGCTTGATGACGG	AGTGCTTCTGAAACGGCGCA	13
ATCGATATGCATTATCCGTTGTG	CGACGGAGGTCAGCCACTCTTTCCACA	18
CAGCAGATCGAGGTCGAGGTTAATTATCGGACGATT	GGCGTGGCGAATTATTGCTTCCGCTATTTGCCGCTGCGCCTG	26
GAGGCGGA	TACTTTTACAGCA	9
GACGTCATTATCGATCTCTCCTGCCGC	GGTGTGGAGTTGTCTGGGGCTGTATATC	17
GA	AG	2
CGCAACGAG	GGTTGCTCTG	7
GACGAGTTCGCCGGTAAACATAAAG	GTATCAACAAACTCACCTTCCAGCACAA	17
GCCAGGTGAGTATGCGCAGCTGGCGCAGCTCAACG	ATTGATTGCTCAAGTAGTTAAAAATGCATTAACATCG	23
GTCGATGGCGGTACTCAGGGACTGAACTTGCT	GTGAATCACAAAAATCCCCCTACCCCGTCACGCTCATAT	24
GTAACGCGCGTGTTGATCCCCGGATGATAAGTTCG	CAAATTAAGCGCCGAGGCGAGTTGCGCACGGGGAGTGAAA	23
GCGAATTCATCCAGCGTGCGTACGATCTGGGCGCTGAC	ATCTGGCAGAGTTCGACCCTGCGGAACTGCTGGCCCCT	22
TGCATTTTTGTG	AATCATTAAACAGGC	10
GTATAACGGTCAGGTATTAAGTAACGTTGTAAAAGAAGCCAA	GCGTTGCTGTTCATCAAGCTGAATGCAGGGCGTATTGGCGGGCTTGCCATC	29
CAGACGCTGATGCTGGCCCTTTCTATGGTGGTCATCGCCTCGATGA	CAGGTAGCATTTTCGGCTCCTGCAAAGTGCCGTCGAAGTTTGGCACC	26
G	AAGG	3
TTACCATACCGCGAACAAA	GCGCTGACAGGCCATGAACTGTCACC	16
TTTCTGTCATGATCTGGCGCATCAGTGCCGAATCATCGACAGATA	CTATCAGCGCGTAGGTACTGCCCAGCGTGACGCCGTTAAACATCTGC	25
ATATTCCT	GACTCCGTAGAAAT	10
GCCCAGCGAACAGCCTTTAAGAAATACGACCGTGC	ACCAAAAATTCCTGCTTGATGGCTATGCCAATGAAACCTCTC	24
GTTCTAA	TTAATAATGA	6
TTTTCAGGCACGCCGCAGCCGTTA	AGCTTCTTTCATTCGCTGAAAGTGG	15
ACTGCCAATACC	ATTTTTTGCTGCTGGCAGCTC	13
CCAG	TGCAG	2
GCGCCGCGCTACTGTCAGTACTACAAT	CGGGCAACAATCGCTCACCACAATATCAAAGCGT	18
TTC	GGAAAA	6
GATTTTGACCGACTCAGGCGGCATTC	TCAGAAAATCCGGATGAAGCCGGGCGT	17
TGCCGTCTTCGACCACTTTTT	GGCGAAAGATGGCAACAACTTCGTCTAC	16
ACATCGATCCGATGGCAATGTCACTGCTTACCGCCT	CCAAACCCGGCTTATGAAACGCTGATGAACGCCGTGAAACTG	25
TCATCGACCCGA	TAAAAAGGATGAACGTGGCGC	14
CCCGCCCCGCTCGCTGGTGCCAAGCTCCAG	ACCGCGCAGCCGCCTTTGACCAGCAAAAGCG	14
ACCGGATGGATCATTC	ATCGATCGCTTCGTTGAGC	9
GCATTCCGGTGATCGGCTTTGGCCCGGGTAAAGAACCTGAAGCG	CTTATTAAGTTTGAATCTTGTAATTTCCAACGCTTCCCGTTTTATCTT	31
GATGAGCGAGAGATCTGAA	AAATGGCATGGCTGGAAGCCCAGGAG	14
GCAGGCATTTTGCTTCCTGATGTACGCCCAGACGTTTGCACTGATGCAGT	ATTTACGAGACAGACACTGGGAGTAAATAAAGTATGCCTAAGTACCGTTCCGCCACCA	34
GTTAGTGTTATAAACTGAAAGTTAATTTATTC	TTGTAGCATCTGATTTACGGCATCTTGTCGCTGTTAA	20
CTATTAAGCCTGTGAGA	CGGCCAGCGGTGTTGGTTGTC	13
ATGGTAAATTCAGTAAT	GACGATACAGCCGCCAAATCCG	13
AAAAGAAG	CCTGATCTTTACCA	12
GCGAACTTGCAGGTTTGTTAGGGCCACAGGATGTGGAGATCCGCATTCC	TGACACGATTCTTCAGCCCACCGTGTTTCAGTGCTTCGATCACTGATTTA	28
TATCGCCAAACTCAAGTTTGTTAAAGCGATATTTACCACAGG	AATTATTCCCAACATGATGAACAGGATGGAGTTAAGTAATGAATCCACTG	26
CCGCTTTTACGGCTGTTT	AGAGTTCAATGACGTTATTGTT	13
GGAGAGACAGATGATTGAAATAGAATCACGCGAGCTGGCAGATA	TCTTTGCTGTACATATCCAGTTGACCGTTCGGGAAGCAAAAACGCATA	28
AGCCGGGATCAGGCAGATATCGCGATGCCCTTCGTTGCGGCTTTCA	TTTAGTTGCACCTGTATAATGAATAAGAAGAGTACTTTCTGTAATC	30
TG	TTCCG	3
TA	CGCTTT	5
CAGCCCTTAATGCCGTAATGCTCCA	CCGCGATGCGCTGCTCGATACCTATCAACA	15
CCAGC	AGCAAT	4
TTT	ACGGCGAC	8
TTGGCTTTTTC	CAGTTCGGCGGTTTTTT	7
CCAGGAGTTCCGCGCTAAAGTG	CATCACGTTATCGGTGGGTCACTCATT	16
GCCGCTGGTCGAAAGTCGCTATCTTTACGACCCGCTGGGCCGCAGG	CGGAATTGAACCTGTCATTACCAGGTAGATAAAAAGCCTGTTCAATTTTGGGA	34
TGCGTACCGGGTTGAGAAGCGGTGTAAGTGAACTGCAGTTGCCATGT	CGACAATGACGCCGCAGGCTTATAACAGTATTCAATACGACGCCGAAAAATCGCTC	31
GTAATAATTGCCGCTATT	ATGCGTCCGGACCACGGTCATCAG	16
CGGATGCAACAGCGGACCATAGGTCGCGTTAACCTGT	GCCGGAACCGTGCTGATGCCAGTACAAATTGGCTTGAAGGGAATT	25
GCGGCATCTCTTTTACATCCTCGTAGAACGGCATGCG	TCGCCCGAAACGCTGAGGCAAAGGCGCTTGGCGTTAAAATGGGCGA	26
TCACCGGAACTCGGCAGGCGCTGAAATTGATTGATGATGTTGGTTGC	CGCAAATCGTTACCGACCATTGATAATTGCTGAGCGCGCAAACTTAACTGCACGCG	33
CGCAGCGAT	CCACCACAATGG	7
CCCGCACTCGCCTGGTTGATGGTGACGGGAAGCGTCAG	ACCTGTTCCGGAGAATTTCCGTCTTGAAGAAGATGATG	23
AATTATCAACAAGTTGAATCGATAAGAG	ATGGAAAATTCTTAGAAACCGATCACATACAGCTGC	19
AGTTGCCAGCTATGCCAGCCAAACATCGCCTGGCCGAACCC	TCACGCTTGCCGTAGAGAATTTCCCCCGGCGTATAAAAGAGATCGATA	30
ATTTAAACC	CGGTATAAAAGG	7
CATTCTGGAA	ATAGGTTCTGGAGCG	7
CCGTACGTGAAGGCCGTTCTCAGG	ACTGGCGCGCCTTTCTCCAGGCAATACT	17
ATTAGCGTTCTGCGTTAAGA	GACGCCCAGATTTTTTGCCCCT	16
GCGATCGA	CGAGATTCA	4
TATGCGCC	CGACCAGC	6
GCTGGCGGCACAGGCTATCCGCGCGGTGGCGCTGGGTGTGGTG	CCAACCGGAGCATAAATACGACACGGACGGTTAAGTTTGCCGTCG	23
TACATTATCATGCATA	CAGAGAAAGACGCATTGCTGA	12
CGTCAAGGGTCAATACCTGCAAGAGTGCGTGAAGA	CCAGAATCTTTGGCGCAGGGATGGCAACCGACGCCTTT	24
TGGGTTCGGCGTACCGACGCTGATTGCCGTTCAC	TCATGTGCCGCTTCAACAATGGCGCGATAACCGGCGATGTTC	22
ACCGGGAAGGTGTCGAAGAAGGCATACAC	TACGTCATGGCAGTGAACGTTCCATCCTGGTTG	20
ATGAACGCCTGATTCGGCCTACAAAGGTT	CCCTCTTTATCGCGACGCACAAAGATCAGCA	19
ACGCGATTGCTGCGGCCTGCTACT	AACTCAGTTGCAACAGCAGCATTTAGAAAACCA	18
GCGACGCGTCCCGTTGCAGCCAC	GCTGGTTTGCCTGGCAATCTGGATGGCGCTG	17
CTTCCTCATCCGCACGGTTCGGACCGACACCCACGTAGTGGAA	CCAGCGCCCATCAGCGCCGAAATTCGCAAGGTACATCAGTATCT	23
GCCTACAGTTAAGTGT	AAGTGCTGAAGGGTGGCGGGGCG	15
ATCACCAAAGAAGTCTTGCCAGGA	GTAATGATGGTTCTATTAGTGCATCGAAAA	18
A	CTGTGCGGA	8
TTGGTGATTTATCAATTTTTCGTTAAGCACTGCACC	ATGAAATTGCTGGCGGAACGCGGCGTGCAGGTGTTCTTC	23
TTGTAGTGGCGTTCTCTTTCAATATTTTACCGCTGCCTTCACAAAAGG	TTCCTCAACGCCTGGCTGATGGAAATCGTCCCGTTGAAAACGCAGTTACGTTTTGGC	32
A	GTCCGC	6
A	AAAACTC	6
TCGCAGAGTTTTGAACAGTTTTCACCCTTTCGTTAAATTCTTCTGAATA	CTGCGCCACGGAAAGAAGGATTTCTTTACCTGGAACATGGACGGCGTCTTGA	30
AAATCGCCTTTTTCGGATTAGGCTCTTCAGCCGCCGTTGC	CTGATCAACCAGGCGGTGGAGATCGTGCGTAAAGGCGGGGTGATTGT	27
GATAGCGCACCGGTGCCTTTTGTTATTCATTTACGGGAA	CCCTGCGCATCCTGCTGCGTGGCTCCCCGCTGATTGAGATGAA	22
AGCCGTGGGGTAAAGAAGGG	CGATTACAGCAAATCATCACTAACCTG	19
AATGCTTCGCTTAA	TGAAGTGCAGCAGATATGTT	11
GTTTATTTGTGCA	TGCCCGTCGCTGGCTG	11
CGTCTGACACGGAC	AGTGCAGGATGGAAGTCGC	11
CGGTATTCTTCACACTGTGCTT	AGCCCGCAGCAGCAAATGCCATATCAATCG	20
TCTGCCACCCATGAGACGCGTTATGGCAT	GGGAAAGAGTATGGATCAGGCTCCAGTCGT	19
TTTTAATGTGGCTGGGGTACGAGGATTCGAACCTCGGAATGCCGGAAT	TGACAGGCGAGGGAGTGTCCAATTATGAATTCAAAAAAGCTTTGTTGCATA	30
ACATTGCGCCAAACGTCTGGTACAAC	GCTTTTGGTAATTAATCCCGGAAATAATAAC	17
CAACGCCGCCAGCGTTATGCCGCAGGCAGAAATGGCGATATTCTGGA	GTAATGAAACCGCCACCACCGCCTGTCTTCTGAATAATCCCCGGACGACCCTCT	31
TTTGCAGGC	GGTAAAAGATG	8
TCATCAATGTCTGATTTTACGTGCGGCGTCCGGCGATATTC	CGCCATTGCCGCTCCGGCAACTACCGGGTTAAGCAGTGTTCCA	25
ACACGCCAGATTTCGACCGCTGTTTTGCCTTTATGCAGGCGGTA	CACCCGCCGTGGGGTTGCCAGCGCTTTGTTAAAACCTTTGATTAAGTCTGAA	22
CCGT	GCAGTTCTTTTG	9
ATT	TCCAGCGATTCA	9
GCAGGTGACCACCAGCGCAGAACAAATGCTGAAGGGCCACAAAGAAGTAT	CCATTGAGCAGTATCACGCGCATGGTCGTCAGTTGGGCCGTCTGCTGTACCAGGGG	31
CAATATTGACCGCACTAACGGTA	CCCAGTTCCGGCTCGTGGCGGTAT	12
TATTTATCGACATGCGTAACCACTATGAGTATGAAGTGGGGCACTTTGA	AGAGTGAATCGCAATGCAGGTAATCATTTCATCTGTATATCTGTATGCCAAC	27
TTAGTACAGTGCGATAAA	CTGGTTGGGGGCAACGGCAAATC	13
GCCAGCCGCACGCCAAAGGGCGTCGTCCGGTACGTGC	TCACCGCGTCACGCCGATATTTTGTTATTTACTGGCGCAG	22
ATT	TGCGTGAAACGG	11
AATTGCGAAAATATCTCTTT	CTATTACGCCCGCGATGTGCAAATTAA	16
GTTGCGGCGGCTCATTTTGGTACGAATGAAACGCTCGTAGTGCCCC	TTTAATACCGCGATCAAAAACGCTGTCGCGAAAGGTGATGTTGATAAGGCG	30
CAGCCAGACTAAGCGTGAAATGAACTGTTCCTGACAAACATC	GCTGGTCGATGGCTTTAGTTTCCCGGCCATTACCCGCCAGATCGCCAA	28
GGACCGGTATCGCCGGCACTCAACATATTGGCGAGATATTGCACCGGAAT	TTTTACGCTCCATAACTTTGGTCCAGACGCGTTTCAGATAAGCGGCATCGGAGGC	31
GCCAGGCTGCGCTTTCGGTAGCACGGTACACTTTCA	ACCGCTGATGACGGTGTAACCGATGCGGTTTTGGTCGTTGA	23
TAAGGAAGGTCATGTAATAGCTGGCACCTGCG	ACGCAAAAAACGCCCGTATGTGCTGGTTGGTGCATTC	20
AGGCTGGATAAGATGCGTCAGCATCGCATCC	AAGCCTCACTCGTTTGGGATGAAGCACAAAAACTCACC	20
TGGCGACAAACTCGCGCCGAGC	CATCGCTGGCTGGGCGGTATGCTGACTA	18
CCTATACTGCCGCCAGGTCTCCGGAACACCCTGCAATCCCG	CGCAGCAGATTAATTAGCGCTTCGGCATCAAGCTGTGCCGGGGAGAA	29
GCACAGCGAGCACCGGGGTATTCCTTGG	TATTGCCCGCGTGCACTCGCTTTTTCCAG	15
CAGAAGAGCAAGGTGTTACACCTGATAAACTGACCG	CGCAGAGCCAGTGTGGTCAGTGCGGTTATCCCGGCT	17
AGTCTGGTCATCGGACAGAT	TTCGCCATTCAGGCTGCGCAACTGTTGGG	18
ACCAATCAACTGTGTGCGCGCCACG	TTTCTACCACCCTGAACGCGGCGGGCAG	14
ATTTGAAGCCGTCGCCTCCCGC	TGAATGAGCAAAAAAATCAAGAGAGAAACG	21
CCCAACCTAAACCAAGCGCATCCGCTTTGCCGGGGACATCCATG	TCCAGAATTTTTCGTCATTCGGGTTAGCCAGTTTAGCCATTCGTT	25
AGC	ACTCTGGTGA	8
ACACTTTTTGAATTTTTGTAAATGTATCCGTAA	GCACGCAGTCGCCATGCACCTAAATTCATCCCACCGT	21
ATCAACAGGTCAAGGAAGATATCGACGCAGAGCAGTTGGCTACCGGAGAC	TGGTGCGTCTTATCAACTGGCTGTTGAACTGCGTGAAGATTATTACCGTCA	29
AAGCAAACGATCAAGCGTTAAACCCAATAATTG	TTTGATCGCCTGCTTTTCCAGTTCCCGCACGGTATGCAGAA	28
CCACTGGCCGT	TCAGCACGCAGTATTGGTGC	13
AAAATGGCTATCAACGTAA	TCATCGATAATTATGCGGCAATCC	14
AGCTGTCTTTTTCATTTTTTGCGCCTCGTTATCATCCAAA	TCTTGTCGATGGAACAGCAATCAGTGCGCCCGGGGGCGGCA	26
CTAACGGACGCAGAATCGACTCCAGCGGGACAAA	GCAAATACGTACACCGAGGCCATCAACGACTGAC	18
GAGAGGCGATCGATCCCCATATC	GAGGGCTTCTCTCCAGTGAAAAATAGT	15
CTGGCTGTTTGCCGGTTCCCCTTCTG	ATAGGTGGCGTGGCCGAGAACAAAAACCG	16
CTCCTCGTTT	CGACCTGGGGAATCA	9
AATTTTTTGATCGGATCCGTTGATGGCGTGGCGCTGACAGAT	GCCGCGATTGCCGCAACCCGCAATTTCTTTGAGCAATTAGGCGTGC	29
CATTTTTGCCCCTAAAGTGTTACTCCTGAAGCA	CACTGACCACTTACAAGTGGATCGGCATTGGTGATTAC	21
AACTTGTTCTTTCACTTCCGGGCGGG	AGTTAAACAGCCTGTACTCTCTGTTCA	18
TCG	GTGGGTTTCCT	9
ATTAAGATGCTGGCGCATTATTGCTGCTGCTTGC	TCCGGAAAGGCGATAAAAGAGCGGCGGGATTTCAT	21
CG	CGCA	2
AAACGGGGGCTATAAATAAGACCTATTTTCTAC	ATCCGGACCGTTGCCACGCAGACCCGCCTGCACCAGCGA	23
AATCGCTGGCAGGCTTTTTACGTCCGG	CACTGCTCTCGATTGTCTGGCTGAAGATG	18
CTGGCAAGTGCTTATTTTCAGGGGTATTTTGTAACATGGCA	AGAATTACAGGCATTTTACGGCGCACTGGCTGGGCAAAAAG	26
ACATGACGATTACCAGTTATGAATGTCGCTGGCTGTATC	AGCGCTCCAGATTACCAGCGACATCACCGCCGGACGCGT	20
CTGTGTCCGGTCACCCAGCCCACATCGGCGGTGCACC	CTTCCAGACACAGTCGTGCGTCATACAGCAGATCCTGCGTGCGG	23
CAGCTGC	CTGCTCACCG	5
TTG	TACGGTACGCT	8
CGACATCACCGGGCGAGTACATAAGGACCGTAAA	TGGCCTCACACCAGAACAGATCAACGATCGCTTTAATA	18
ACCGGTGGTGTTGCAGCCCATCGCACGGACAGAAGACTCTTTAAAGCGCA	GACGCTAAAGCTGAACTCGATAAAGCCGGAAAATCTCGCGTTGATCTGCTGGCGC	30
CTTGTTTATCCTGCCAGTGACCGGTAACCACGGCATG	GTCAAACGAAATGTGACCAAAGCTGTCTTTGTCCCAC	25
TGATGAGTTACAGGCGTTGCAAACACAGCG	CTGGTAGTTAACTTTATTACCGGTTTCTTTC	20
TGCCGCGACGCGCGGTTTAGGATTTATGGTTCAG	AGTTTGCGACCGCTAACTATCTTGCCGCCGATCAGGT	20
AAATTCCAGTACATAAGCCATACCTGAACACCCGGAGGTTCTCAC	CCGAAAAGCACTCTCGGATTCCTTACCGAATCCAACTTATGTTGTAAACT	26
ACAGCAGTCCAGCGCGAAC	TATCGCATCCTGCTGTTTTAC	10
ACTGGCATCAGGGCTTTCTTGTCCGGTCG	AAAAAAGACATATCGATTCTCTGACCGAAGA	17
TGATTGGGCAGGT	ATGAGAAAGCCGAG	8
TGACCTCAAACCTGTTTGCGATCCTCGGCCTGCGTGCGATGTATT	TGAATCACCGAAATGGGTTGGGCATTGGTCTTCCCACTGGCAACTTCCTTTTGT	28
CAGTGGCTGGTCCAGTCCCAGTTGCTGGCGAATATTTTCCACGATA	ATGTGTTGTTAACGATTATAACGCTAGGTATCTATTTACCATGGGCATTAATG	29
GCCTGGCTGACTTTGTCGTACAGGTCCGCTTTACGCA	TCTGGTAAGTAAATCATTGTCATCTTTCGGGCTGGTCTTC	23
TCGTTGTGAAATTCAGGTTTCCTACGCAATCGGC	ACAGCGCCGCCACCAACAAAGCCACCATTGAATT	24
TCTGTTGGTGCAAGGGACGGCA	GCCGGGCGCGAAGATGAGTGGATCCCTA	15
TCTTAAGCCGCGCCAATGGGTAAAATAGCGGGTAAAATATTTCTC	CGGGTGGTGACCAGGAATGTTCAGAGCATCGAAGTTATGATAATCGTCTTCG	29
CATGTCAACGACAGTTGTAGGCCTGATAAGACGCGCAAGCGTCGCATC	TTTGTGCGAGAGTTTGTAGGTGATTGCTGATTTCACTGTCCTGCTGATA	25
GATGGTGTTTGCCAACGCACACGCCACCGCGGCGGCGGCAAA	TTGTAGCGATAGTAGCGATGTCGATAACGACGGCGACGGAACGT	23
ATCAAGCTGTAACGTTATTCTTTCATAACCTTT	TCGACTTCTCGAAACTGGAAGCAGGTAAGCTGATTCTGGAAA	25
TTGGATCGTTC	CCAGCGATCCCCTG	8
ACCA	TCCTG	3
ATGGAGTTATTGAAAT	GGAATCATTATGGAATCCGTG	12
TGTGACATCTTCTTCAAGATTTTCGTGATAAAACGTCAC	ATTTTCCGGCCTTCTTCCGCAGTGATAACCGTTTTTCCTGTGCTTGC	26
GCGTAAACGCCTTATCCGGCCTACGGA	AAAAAACCGAAGAAGCCGCCGCGGCAA	15
AGGC	TATCC	3
GGTTGTTTAATTGCTTTCGGCGGTACTGT	GAAAACGGCGAACGAAACTAAACACCGTTAA	23
GCGTACGGTGTAAACACGGCTGTTAAGCGGCGTATTGTCGGCAACCA	GTCATCCTGGAAACGTTGAAAAAAAGTGATGTCGTTTGGCTGCATGGTACTAT	27
TGCCATTATTGATAATCCGG	CCGCCGCAACCGGTACATGGACTGAAG	15
CTTTAACGTTGGTCAGGTTGATGGCGTTAA	GATTATCGATCTGGCGCTGCATATTGTTGGCGGT	15
CAGCAATGTATTGGTGTAGAGATTTT	CGTGAAAGGCGTGTTCGCAGCGGGTGA	15
ACGACTTTTTGCCGGACGACACCCGGCTGTGGGCGGCACTGCAGTCGG	TTCCTGCCAGTCGCTGTCAGACAGCGGCTTATAAGTTACGGCCATGTT	28
CTGTTTCGTACGCGATCATG	TTCAGCGTGCCGGTTTGTTGCGG	15
ACGTCACCTTTAACGTGGATCATGGAAG	CCATTATCAATCAGCAGACCTCCGGAGCC	17
TCGC	CATGTTCCACCG	9
ATTGGTTAACATAATACCCGCGCCCATATC	TCTGCCTTATTTGTGGAAAATTACCTGACC	21
CACCGATAAT	CTTTGCGGATG	7
CAGAAACGGTGAGAGTGCAGGTTCGGCAGGAAACGGCGTTTAGTCGCG	TGGGGCAATCACGGCGGGCTGCCATCAGCAGTTGAAAGAAACGGTGGAGG	28
TCGCGATGGTAAACGG	TCGGTCTGTTCCTGCTGCTCAT	13
CAGAATGGCGAAAAGGCCAAAACCGTGCTTACTGGATCAAAATTT	TGGTGCCAGCCGCGCGGAGCAACTAGAGGAGAACGTGCAGGCGCTGA	31
GCGGCGCTGGAATGGCTGGCAGATTACGATATCAACCAGGCCGAAAG	CAAAAAACCATAGGTTAATTAATCCCGATATTGAACATTGAGTTAAAAAC	30
GCGTTCTGCCGCATCTCTTCA	CGAAAAACTTCGGCGGCGAGCAG	15
CGGCTTAGTGCGCAAGGGCAAAAAATGGCAGCGCTGGGTAACGATCCG	TGCGGGCGGTTGCCCGGCATCCAACGCCATTCATGGCCATATCAATGATTTTCTG	31
GTTGAAGGCGAGCGCAGCATCCCGCTGGCGCAGCGTCG	TAATACTTAATAAAAAAATACTGACGCGCCGGGCATCCTCA	24
TCGGCCTGTACTGACGCGGTGAATGC	ATCGTACTGCCGAGCACTCTGCCCAGC	14
ACGC	ACGA	1
GGAAATTCGCCTCATCCAATGCAACAACGCGGAGGAAGCATGAGTAAGAA	GCAATCGCCTACAAAGTCCAGCGCGACAAAAATGCCAGAGAACTGAAGCTAGCGAAC	24
GTCGAC	GCAATCAGT	6
TGAACGTTGCAGGAGTTACCAGTGAAATT	TTCAGAATTTCATCAAAAATTACCCTGATTCAACT	17
CCATTGAGCAGTATCACGCGCATGGTCGTCAGTTGGGCC	CAAGCAAGGCAGAACAAAACTGATAATTTTCATTTATTG	22
GTGTTGCAATTTACTGATTTC	CGAAAATAATCAATAAGCGCC	15
GCAATG	GTACGCTGTTTTTGT	11
TGAGCGTGGAAACGCGTCTT	ATAATTAATGGCCGTTCAGCTT	13
GCAACGGTGCTGCAATTCCTCTCA	TCTGAGTACTAAACAAAAACAGCACCTG	18
ATGTTTGATGTTAAAACCCGCCAATTCAGCCTGACCTTATC	GCTGGATTACCGTTAATACGTTAGGGCGTTATCTGACCTGTCAGATAACG	25
CGA	AATATTTTTAAA	11
GTATTCACCGAAGGTCACGGGACGCTGTATGCCAGCGATGGTCGTACCC	TGCACCGACTCTGCACCGTCTGGGTATCCAGGCATTTGAACCGGTACTG	25
AGATATCAAAGAATTTGCGCGCCGGAACGGTCGTCGCT	CGGTGTCTTCGGTACGGGAAGAGGCTACGCGGTGATAA	24
CCAGCTCGG	TATATAACATTACGTTAT	13
GCGCGCTAACGGAGAGCAACG	GCATATCGGCGAGAGCGCATCCG	11
GTTTTTCAGCTCGTTCTATAAACGGTGCCAGACTCATTTTTTCG	CCATTACCGAAATATCCATTATAGAGTCTGCGTACCGTGATGACAGAGT	30
CAGTCAGAACGGGTTTAGCGAAAACGGGC	CGCCGGAAGATAAAGGTTATTTCCAGCGCCTGCTGG	19
AGTATTTGAAAAACGTAATTGATTGCGAATAGCAACAA	TCACCGTCGGCACAAATCCACCATACGGCGTGCCACGACCAGTA	26
GATTGACACATTTCATTCAGATAATGAATTAATGCT	ACGTCATCCTGGATCACGTCGTTGGATTTATCTTCAAAGAAT	23
GCTATAAGCAGGAGCAAACGCCGCTGGCGGTGATTGCCG	GGGTTGGTGTCGGATGCGATGCTGACGCATCTTATCCGCCCTACCA	26
CAGTGGGACGTCACGTAACCGTGGGCGT	CACCCGGCGGTGATCTACGCCGCACTGGTGAGCATG	17
TTGAGGATGAAAATGTCAGTATTTCCAGAA	GTACCAACGAAGGAATCGACAGCATAATGTC	18
CAGCGATACCTCCCAGCGCG	CACCGTGAGCACCATGCTGCTGAAAGTGA	15
GCCGGAGGTGATATCCACCTGACCGCCAC	ATGCCAAAACCTGGCATCTTAAAGAGTAA	19
CCTTTGCAAGATTCACACAGTAATATCTTTCCACTCG	CGAATCCGCAAACAGCAGATCGTTTCTCATGGTTTGATTACCGCTC	25
TTCAGCGTTTTCGGAATT	GATACATCTTTGATGCCTTTTTCCAGA	17
TTCACCACCTTTGAAGTGGCGGAGCTGGTTATGCCGCGTGTTGTAAAAA	CAATTGCGATCTTTTCCTGTGTGGTACGCCGTCTGCGTTTCTCCGGCCCTAAGACA	29
TTCTCCATCGTCGCCATTTCAGCTTCGGCAACTTTGGTGTTACGGCAT	GCCGCTGTACTGGCTGTAAAACCTGCGAACTGGCGTGCAAAGATTTTA	28
AACGTCGGCTGCGAAGATATCG	CCGTAAAACAGCACTGCCAGCGATAACG	13
ATAAATAACATTACCTAAAAGGAAGACGTTATGGTGAA	GTCAGGTGAATATTGACCAGAATCGGTGCCATTCCCGCGTCA	21
CTCTCCCAGGCTCTGGAATATAGCGATCGCTTACAGGC	AATGTGAAGGAGACGCCATGAAAGAGAAACCTGCTGTTGAGGTTCG	25
CCGGTGCG	TTATATATGC	8
CAGTGACTGTTACGCTGGACATCA	TCCGGGGCGTTTGAACGGATTGGTCGCGA	15
TCAGATGGTAGAAAA	TGAATAAAGCAATAAAAG	9
GATACTGCCAGCGAATG	AAAAATAAGTTGCCACGCTTC	11
CCGACCCAACAAACGGCGCACCGCGTCGTAAACGCCC	GGTTCTATCCTTGCTGTACTGGCGATGACACCAAAAGGTGCTTACT	28
TATGCAAACAA	TTTGCCATATCTGCGC	9
ATGCGTAGC	CACCGGAAGTA	7
TACAGCAATTAACCTAGGATACCGGTT	GCAAAGTGGTTAGCCAGATAAGAAAGCACTGGA	17
GACGGCAATCTACTGCGGGCTGAACTGGC	CTGATAAACTGACCGGCACCATTCAAAACGATATTCT	23
ACGGCGG	GGGGCCGCCAGCG	8
CTGGAACACCCTGAACTGCAGTTAATGGAGGCGAACTATAGCCAGAAGCA	TCTGGATATTCAGGCCAATCTTGAATCAGCGGAAATGCAAAAAGCATTGA	26
GTGGTGAAGAAA	ACGGCACTCGTTAAT	10
TTCGATACG	CCTTGCCAGTT	8
CTCTACAACATTTTGTTGTTTATGC	CGTTGTCGCTGGCGATGAGCCGCAAGGTTTATT	20
CATCAGGT	CAATATAACCG	7
ACCATCAATGCTAAAAACCCCCGACAAGCGG	TAAAGCCTCGGTTCATATTTAGCCCGTGGTCAGCATCG	21
CCTGGATGACGG	GTCTATCGCTATGCCGAT	10
GATTTCAGATTGTGAATGTCAATCGTATCCTGACGAGCAATCA	GTAACGGATTACGCGATACGATATAACATCTGGAACTTTATTATTACAACTC	26
ATACGTTATAGA	GCCCTATCGATCTGATTA	10
AAGTGTGACTTCATGCTCGACCAGGTAGGTAAC	AGATGGCGAGCTGGCCTGGTCGAAACTCAATAACTCCAA	19
T	CGCGCGGCGC	10
AGATTCGTTCGCT	CATGGCTTAAACCTGACTGC	12
GGCCGGAGATAATCTTCAGATCGAAATCTTTTTACCGCCGCGA	GATGCCTGCATTGGGCAGCATTAAGCCGATGCGTTCGCCTTCAAC	26
TTGCAGGATTTCATGAAAATTATCCGTGACGATC	CCCTCATGACATTGTGGTTTTTGTCATTTTCCTTT	21
TTCACATGCTACAAAATGGATATTAGGCAACCTGTATG	GCAGGTGTTATTCCTGGCGGCGGGGATCACTCTTGCCGTTTCACC	28
CCAGAA	AAAACGCTGGC	8
CATGCTCAGGATCTGGAGATTTATGACCAGC	CGGCATTGAATGACAGGTATGATAATGCAAAT	17
ACAAAATACTGTTAATCAGCGAGTTGAGGA	AGACCATATTTCAAGCAATTACCGGATAATTA	17
CTTTGGTAATCAAGCGTTTTCGCA	TATGATGACTAAAATAAAGTTATTGATGCTCA	16
GGAAAACTGGCGCACAGCCTGACGAA	CGAGTGCCTCTTCCGTGGCGCTTATTGAAGGTGT	21
CGTAACCCAA	TCATGGCTAATCTTGT	10
GCAGG	GTCGATTC	5
TAACAACGCTAAGTGGATCGTCGGTGCGGCTGCAGGCTTC	GATAACGTTCCGGGGCCTCTTACGCCGCCACAGCGCCATCTG	21
GCCCAGCGGAAATTACC	ATCAGGAAAACAGTGGAACAACT	14
GAGGTCGTCAATGCAGTGGACGTTCCTGTTACCCTGAAGATTCGCAC	GGCACCAGCGCCCTGCGCGGATTCACGAATTGCGCGGCGTTCAACCTGGGTCGCGC	29
CTGAACGCCTGGCGCACGGTGGCGGCGGAATAGA	ATCAGAATCACCAGCAGGCAGCCTACCCAGAGTTGCAC	21
CGACCATTACCGCTGAGA	ATGAAATCAAAAGACACCCTAAAG	14
CGCCCGCG	CGGGCTGTAGC	6
AAA	AAC	1
CGAATACAGCCAGAACTTACCCGCAT	CTGAATTATTGCGCTACGATGCGCAAGGACG	17
TGCAGCGGTCAGAGTAGTTTTACC	ATCTTAACAAGAATGTTAAAAAACGC	17
AGTGTCCCCAC	CCCAGATCAACAATTTC	11
CCTGCGGTACGTGACATTGCAGACAGAAATA	TGGTAAAGGCCATAGCCACCGCAATCCCCAGCCATGTATA	23
ATTCAGCCAGACCAGCACCGACGGTCA	GGCGGCAGTGCGACGGTCGACGGCGGTATGGGCA	18
CAGATTGGTCGCGAAGGGATTAGCGGCCTGGGAACGCTGC	TTTTCTACAAAATGCAGCAGGCGGTGCCAGATAAAGAGTTA	25
GTACAGCAATATGGCGTTATATAAAACACGCAAGCT	CGCCGGGCGATGTTTATCAGACGCTGACGACCCGCCATCCCTCTG	27
TGAAAGAAGAATCTGACAGCGTCTTTATGCGGGTGATTA	GCAGGATGTGATGCGAAAATTGTTGCCAAGGTTGAACGTGCGGA	26
TCGCGTCG	TGATTGATGACAA	9
ATGGTAATCAAACCTTCCGGCGTCGAGTACGACGTGATGACCGCCG	CCGGTTTTTCAGCATGGACCCAGTGACCCGCGCCTGCAATCACATG	27
CGGCACC	TGATGCCAGCCG	6
ACCG	TGCCA	3
TATAAAGAGCACGGCGAAACCAGTA	TGGTTTGTCACCGGACTGTTTATTCTGTTTGC	20
CGATGCCGACCGCTACCCACAGCTCAATGG	CTGGAGTTATTTACCGGTGATGATCAGGTTA	19
CAAAATACGTGTTGGCATGACGCAACAACA	TGATGTCAGCGAAGAATGGTCACAGGTTGGCTT	22
TTTTAAAAAAAATCCGACTTTAGTTACAACATACT	GCACCTGAAGGAGAAAGAGCATAACAAAGCGTTTTACCAGTTGT	25
GAGAGTCTTTTCCCCCGCCTTATGGCTCATGCATGCATCAAAAAAGATG	ATTAATTTTACTTGCAGCACGAGTGAGATTGGCTTTGTCGGGACTGCTGTCGATG	31
ATCTG	CTTCTACGTA	6
AATGCCTTTCA	GCCACCATCACGATGATG	12
TGGACCCGGTGTACACGCCGGCGCGAAAAATCCACCTGTAC	ATCACGCGATAGATTCTATTCATATAAACGCTCCATATACAA	25
TGCTCGCCGTTGGTGATGTTGTACACACGCCCGGAAGGTAGCTTATCGC	CGACTTACTTCGTCAAAGCAAGTGGTGATTCTATGATTGATGGTGGAATTAGT	29
AATCACA	TAACTAACTCGTGA	8
AGGTAC	TTTCTCGCGTTTGTG	12
AGCGTTCAGAACGATGATGTAATCACCGGTATCTACGTGCGGAG	GTACGCACGGCGAAAACGAATTCGCCGTCGGCATTCGGGTCGCGGGCTAA	27
ACAACAGGAATCCAGATCGGCAAT	GCATGCGCTGATAGCGGATCATGGTAT	14
TCGCGATC	CTGAAACTGGCAGATGT	10
ATATTGTGGTCGCGGAAGAAACGCTG	CGTCAACCGAATGGAGTGGACTATTTTAGCCTCTG	20
TGTATGTTTGGTGTTAAAAAACATAAACCATCCCTGATAGAG	AAAATGGTGTTCAGGAAAAAGCGGGTAAAGTGGACCATCCCCTGATAAGG	22
AAGAACG	CGGCGTTAACACCAG	10
CGGCCATGATGTCTGAGTCCAGCGTCTGCGGCTGAT	ACGGCTGACAAAACCATTCTGCTTTATAGCGCCTCG	21
ACTCCTATGAATACAATCGCCTCCGTTACGCTCCCGCATCATGTACA	GTTTAAGCAAGTATTGAACATGCCGACAAAGCGGCTGCGTGGTGCGCCC	28
GTACTACCGCACA	CTTTTTCCCTCTGT	9
GCGGTAATTGTGG	TGAAGAGGAAGAAG	9
ATTGCGCTACGAGTCGGGTAAACTGTAGGAAAATTAGAAATAGAGAC	GCCAGTTACAGTCCCGCCATCCATAACCTCCAGTAAGCCGCCACTATCTAC	30
CCAGTCGACCGATACGACCAAAACCGTTAATACCAACT	AGATAGCAGTTGAAGTCGGGTTAGTGGTCGGAACGATA	25
TTCCGCACCTTTAAGCGCCAGGTTTGCC	ATTGAAAAACTCAATACCACGCTCGGATCTATT	19
CTGTGAAAATCCGCATT	TAAATCAATAGATTATTTTTGGC	15
ATTTTCGCAATGCGTATCATTCTGCTTGGCGCTCCG	TTCCACCACTGGAGCGGCGGGAACGCTGCTGGCCTATCTGATTG	26
ATGGAACAAATATCTT	CGCCCGCGATATCAGC	11
GCGAAGGGTCCGCTGCCCGCAATCTCAACGCG	GAAGGAGCGAGGATCGCGGATCGTCGAGAGCGTTTCGCTG	20
CCATTGAGTACGCGAAGAAATATAA	GGTGACTTCCATGATTTAGTCAAGTTA	17
AGCCGGTAGCTTTCTCTTGCCAGCGCGATGTTTTACGC	GATTGTCAGTTATCGCGAAGAGTACGGTCCGTTTAAAACT	22
TTGACCTAACCGTGGCTC	CCGCTCTGTGAAAGAGGGGAAAA	15
AGC	ATCTTCT	5
TGCATGCGCTCTCAATGCCGCATGGGCAGTTTACGAT	ACGTGATTGAGCGGGCGGTACTGTTGACTCGTGGTAACAG	24
A	AAGAAGT	6
TGGCGGAGTAAACACATCCAAATCTTTCAGGCCACGACCTTGC	TCATCGGGCCAACGCCGCCGGGAACAGGCGTAATGTATGAGGCGCGTTT	28
CTTCAGTTAT	ACAAAACCCA	8
GCGCCTTCTACAGCTTCACGCGCCAGCTTAGTAATGCGGTCGTAATC	ATGCCTGCGCGAGCGGTGAGAGCGTTCCGTCAATCACTTCGACAATCAGTTC	27
TTAATCTCACGTTCAGAAGAAAAGTGAACGTACTCTC	CGATATTTTTTGCTGTTCATGATAAATATCGAATGAAC	21
CATATCAGGGACTTGTTCGCACCTTCCTTAGGTGACACTATTTTTTTA	GTGCTTGAGTTCTCGAAGCCAATTATCGAGCCGCTGAGCAAAGCCTATGAT	30
AT	TGACTACGAC	8
TGACCTCATCGGCAAAATATGCCGACATTCTGCTGCCAGAC	CTGGAACAAACCTTCATTGAATACGGTCAGAGCGGCAAAGG	24
AGTGAGTTTCCGACCGCC	TTCATCTGGCTTGCCAGGAACTGC	13
TAC	GAG	2
GCGGTTCGCCCGCAGCGCGGTACTCTGCGTGCATTTTGGCGGTCG	ACGCGAATTTGCCGTGACGCTTTCTGTCGCCATTGGTATATCGTTGCTGGTT	26
ATACGAATGATTGTTTCATACTCCAGGAAGACGGTAAACCA	AGAGGAGATATTCAAAGCCGACCTTAATTGCAGAAAGTGAAA	22
TTTCTG	GTTCAGGAGGAAATC	11
AAAA	ATGCTGTTAT	8
TTCACGCAGCACTTTCAGCGCCAGTTGCAGACGTTCCTGC	AGGTATTTAGAGCAGATTTCGATGTTCTCTTGCAGAGATTCTTCAGAC	23
CGCCGATTTGACCCTGGTTGGAAAACCACCAGGTCTGGAAGCCCGCGC	AAGCAGCTATTAAAAATTTCAATCAACTGCTCGTAGTGGTGTGTACTGTTCATT	32
CTCAAGCTGATTATTAGCCTGGAATAGAGAGTAGAGGGAA	TTGACACGTTGCCCGACTTCCACGCGACCGGATGCCAGCGTTCCGGCG	27
TTCATTTATTGAT	TTCCGATCTGATCATCGC	9
AGGCCTGAATCTGTCGTGCAC	GCTTCTGTGTTCTGACATTGCCAAATTGT	17
CATTCCACAGGGTATGGATAGCGC	TGGTGTTACTGCGAAGGGGGGACGG	15
GGGGCAAAGGT	ATGGGCGCTGGCAGCCGGA	11
CAGCTGGTATCTTCGACTGATTTC	GGCCAGGAATGGGAATACCGTGAA	16
ACCA	TATGGCACA	5
TGGCGCACTGGGCGCGTTGTCGATGGATATCAACAGAGCTGACACCC	AAACGTATCATCAACGAACCGACCGCAGCTGCGCTGGCTTACGGTCTG	30
CAACCACGGGC	TTGCCGGGGCTGGTATT	12
GCTCAACGGATAAAAGGTACTCC	GATTGAGCATCAAAACTTCCAAGATAT	15
ATTAAGCAGCAAATAGGCCGTGCTTTTAGGGATTCCCAATGTG	ATCATTCATGGTGAAAAAATCGCCTTTAAAATCGCTTTTCCCCGTG	24
ATTGACGAGACGAGGCGAATCAGGTTTAATGCGCCCC	TTTCTGCCGCCCGGGCAATATTATTGGTTTGCGCTAATAAAAT	25
GGAAGCGTCGACAGTGCCAGCAC	AGGTCATTGAACTGGCGGTTGCACGTAAAAAT	18
CGGGTTTTGCAATGGATAACCAAAAAAAGAGA	CGCATACGCCGGATGCACTGGAAAAAGCCTTA	17
A	GCAGACGC	7
CAATATCACTTAAATAAGTGATAGTCTTA	CGCCTTCCCCTTGAACGGGAGGGCATTTTTCTGA	17
TG	GGCGTGAAGA	8
CAGCATTCGGCTTAAACAGCCTTCCAG	CAGGCAGGCAATATTTTGATGCCCACTTTCAA	17
CGACGCA	GGAAGATGCG	6
AAAGGCGACAATAAAACCCAGGGCAACTGGGGCGAGGTAGTATTGACGC	TTTTCGAACAAGGTGTGGATGCCGTTCGTCAAGAGCTGGCTCGCTTACAG	31
TAGCCGCCGCGCATGTTCAGCTTTGGCGATACGGTAACCCAGGTA	CACGCCGTTTCACCCGCAGCCAGTCGCTGAATGTGGTGGAACGCC	26
TGGTGAACGTTCCGGTGGATTAGGTGGCTCAAATCTCAC	GGTGCGGAACCGCCCATCGCCATTGAGCGCAGAATACGTC	22
AGCCGTAAACCTTCTGCTAACTCTGTGGTAGCATGCGCCTTT	GACTTTCCAGCAGAGACGCCAGTCGCGCCATTAAAGTCTGGCTG	28
CATCCCGCTGG	TTTCTCATTTACG	8
TGGCAATGCGGCGGTTATCATCAACTCTTTATC	AGACCGCGTAACCATCGACTTCACCGGTTCTGTAGACGGCG	24
GCAATATCTGGAAC	AATGGACGATGTGCAGG	10
TG	CCGCCAATTT	9
ATTTGT	TATTCGCGG	5
GGTCATGGTCTTATTGCCCCTTATTGCGCCTGCCAGAGAATGACA	TCGTAACCGACGCGAATTGCATAGCAGCAGGAGCTGTATTGCACAC	27
CCA	GGCATCA	4
AGCGGCTGGTATACGTGGTGTCAGCGGCGGACAAG	TAAAATGCAAAAGACGCACCACGCTGGGAAAATCGCTGCTATTC	27
CGTCATATTCAACTCATTGCG	GCCCGTGACGCGCACTATCTTTACCGG	15
CAGATGGGTGGCAAAGGTAATCCC	CAGGCTCGATGTTGACCTTCCTCATCCTGCGGG	18
CTGGGGACTTCCGGTCCTGCGGGCACGGACATGATCACCGCGCTC	AAACATTGCTGTTCGGGCGATCAAATTAATTATTGTTTATCCTGCAT	29
TTTGCCGGCTCACGTCAGCGGACCTGCACATTTTGCGGCGATAATTCG	CATGAGCAACGGTACTTACGTTGACGGTAGCACCAACTCCGACGCTTGGGGCTT	30
GCTC	CGTTTTA	5
CGCCAGCTCCCCGG	CTGGTAAGCGCCAT	9
ATTCTGGCGGTTCGTGCACTTGACGCG	CACCCAAGGTGATTATAGAAATTTCACTTTCC	18
CTAAAAG	AAAATGCAG	5
CACTGCTCTCTCCTCCC	TCTCCGCTCAGCATATGGAC	11
AACTGCCGTCAGTGAACCGA	GCCGTGCTGGAAGATGCCGGCGT	12
TCAGCAATGCCAGCACTTG	GCGATGAGAAAGCCCTTTTCCGTGACT	16
ACCGTGGCAAAAGCTCCAAAAC	TCTGTTCAGCGCAGCGTCTGGCGGGGG	17
ATTGACTGATGAAGACAGACC	CTCAGCACTGGCGCTGGCCGCGCA	13
CGGCTTATGAAACGCTGATGAACGCCGTGAAA	CAGAACGGACTGCACCACCACCGAACCGGAGATCAC	19
TTTCCAGACCAGTAATATGATATTTCAGGTTTTGGGCAGTAGGGTCT	GCCCACACAGATGATTGCCAGCACAAGATACCTATTAATATCGCCATCCATACTT	33
GTCCTAAAAATGGCGGGATAACTTGCCAGAGCGGCTTCCGGGCGAGTAA	GTTTGGTGGATTTGCCTCGCACAGCGTGGCGGCGCGAATTGATGACGCTAAACCGGT	32
GCCACACCACCGAACGCGCCATTAACT	ATTGCGTATCTTAACCAAACATCAATAGTGTGA	20
CGCAATTATCGGTAACGGTATGGTCGGCCATCGCTTTATCGAAGATC	TTCGTCAAAAACCTCAACTCCGTTCTCATCAAATTCCGCATCTTCAT	28
TGGAAGA	TGGTTAGTGGCT	7
GTTTGGGTAT	AACCGGGCAAACAGA	11
GGCGCTGATGT	GTTTTTCGCCAGTCAGCA	12
TGAAAG	GATACATGTTCC	8
TCATTAACTGTTCGCCCTGGCTG	GAAGCCATCGCCAGCGGTCAGGTGCAG	17
CAGAACCTGGCGCACGGTATTCCGGAAACTTCA	AATATCGCTAAATTTCATACGCGAAATATCACCTAA	21
AGGTCCGGCGCTTTCG	CGACACCCACACGTCGGTAT	13
CCGGTTTCTTCCCACAGTTCACGGGCGGCGGCTTCCACTAAGGTTTC	GCAGCGGTACGGCGATAGAGGCGATCTTCTCCTCCTGATCCCAGCCGCGGTA	32
AAGGCAAAAACTGGTATTTGACAAGTTATCAGT	TAATTCGTTACGGAGAACACGACCGATGCGGACTCTGCAG	24
TCG	TGCCGTTATTA	8
AGGCTTT	GCGGGGCGCTT	6
TCGCCAAAGTTTTCGATGTC	TGGTAACTGTATCGTTATTTT	11
GCGTGACGGCCAGCGAA	GTCGAAAGCGAGCGAGGATTTG	11
AGCAAGCCGTCGTGAATGCCGTAGGCCCAGCCGTGAATGGT	GGAGTTTCAAATAGCTGTTCTTTTTACGGAAATACTTATGAACTGGCTGG	29
ATTCCCCAGATGGAGTCGGAAAGCGCAG	GCAAGTTACTGGTATAGCCAACACCTCTCAGGCT	22
CGGGAGGCGAGCAGCTTATTAAACAGATCCTGACGAGCAG	TTAACTAAATGAATTTAAATGGATAATTGTTTCGTTGTGTGAAT	28
AATATCCGCTTCATCAGCCTTTATG	TCGTCCAGAACACTGGCTGCACGGC	16
AACCAACGCCACCGGCAGTGA	GAGAGATCGACATATAAATCCGG	15
A	ACGCGCTT	7
GGTA	TTTATTCATTCG	10
GTTGTCTTTGCCG	ATCTCATAGGCGGAT	9
ACAAACCTTGCGTCAGGGATTATTTGAACGAGCC	AAGTTAAAAGCCAGCCAGCCGTCGAACATCGCGT	22
ACA	CGG	3
ACAGTGTTAACGACC	TGGCGCGATAACCGGC	9
TAT	CAAACG	5
GGGCAAGTCTATATCCATAATGATTA	CGCCGGGGAGATACCCGCATCCTGTAACGCGCTGT	19
CCAAGGCGCTTGAGA	CGCGAAGCGCGCAGATTACCCGA	10
AAATAGGTCAGGG	AAAAAATGACCGGG	5
ATCCCGCAAGGGGTCGTTAGCTCAGTTGGTAGAGCAGTTGACTTT	ACATTTTCAGCAGTTCACCTGCTGAGTGGAAATCGTAAGGTACGGACG	29
TCATTGTTGTATCCTGTTTTTAAGTGAT	TGATCACATCAGGATCGTAGTTGGCAAACCA	17
ACGCTGCTTAACTCATGG	GCGATATCACCGCTATCCCA	12
AGTAATGACCCAGTGTAAATTGGGCCATTGATGTATGGAATTAA	AGCCGTAATACTTACTGCCGTCGTACTCAATGCCCAGCGCAATTTTATAAA	27
TGGGCCTGCGCGTCCCGCAGGATGTTTCGCTGATCGGTTATGATA	GCGGCAAACCAGCTGGTTGATTGTCGCCCTGGCAACGTTACTCGCGGCACTTG	29
AGCCGTCAACTACG	ATAAGCGGACCAAAAATTG	10
CGCGTG	AGCATT	3
CGGTGGCGATGTTTTTCAACCGCGAGTTC	CCCGGATATGCTGGTGAAAGAGGGCGACATGCGTT	20
TTGTACTTGTGGAATCAGTTCATCGGAAAGATTCAGGCCAAACTT	GCGCATTGTTATGAGTTTACGCATATGGATTCATCTGGCAAATAAAAACG	25
TTTGCATCAGTATGTCAGCCCAAAAAGAAATATCAACAAGCATATGACC	TCAATTACTGCAATGCCCTCGTAATTAAGTGAATTTACAATATCGTCCTGTT	28
AGAAATC	TCGTCGCTCA	7
ACTGATGTGGCGTTACACCATAATATTGTCGAAATGTGT	GAAACCGAACTTGATCTGTGCGGCAACTTTATCGCCATCGGTG	23
ATCAGTGAGTCAGATGTAAGTTCTGACTCACTGTTGCACAA	GCAGTCAGGAGTTGAGCGTCCGCATTCATGAATTTGGCGGCGGC	23
G	CAGAA	4
TTGCTTCACCAGAAAAC	AGGTGCTTTATCGTCAAAAGTTTTG	14
GCGTCACACCGTATACGTCCACTT	CTTAAGCTACCGCTGCTTGGCTATATGG	16
GAGACATAGCCC	CAGCACCATGACCGGG	8
TTTCAGC	GGTAATGGCCCGAC	9
GGGATCAGGTGCCCGATCACCTGAAAATTACCTTCCGCGTGGTGGATGA	CTGATGCGCGTCAATCCACTGGCACAGTGTGCGTAACGTCTGCGGCGTT	28
TACCAGTAGGGACGGCTT	TGACATCATATCCCTGGCA	11
TTACGCCGCACCCGGCA	ACGACCATCGTCTTTATCTTCAA	15
GATTCTCAATGTGTAGTTATTATTGCCATCA	TGTTGATTGTTTAAAAGCGGGCGTTTCAGCCTCTAC	20
TG	AAAATGGC	6
GTAATGCCGATGAACATTACCGAATTTTGCAGCAAACTGCCGC	TTTCACGCAGTGCTGGCATACCGTTAACGGTAGTTTTCGCCCACTCC	24
CCG	GTGCTTTA	7
TTCACCATCGGCTGCTTGTGTATCAGCCTCGCGTATATGCTCTAC	CAGGATACATCTATTGTCTGATTGAACATCAAAGCACCTCAAACAAACTGATCG	28
GGCTTAAACACAATTTCCTGTTTTTCTTCATCTTCCTCGACG	TCCATGCTCAGCATGTCACCTCTGCTTACGCGGCCTGGGTTATAGCGCGTT	30
GATCAGGCGCTGCTG	TCATCCAGCGTGAAA	8
CTCTAT	TACTCCTTAGCA	7
CCATGCGCTGTTATAGCGGGTAATGTCTTT	TACATCCGAGTTTTATTGAACTGATGGCGAA	16
TCCAGCA	TGAAAACG	5
GGCGACTGACCAATCAGCAGCGAGATCATCAAAATGCCGACCAG	AATTGGCGTAACGCGTACTACGTTACGTGAAGTGTTACAGCGTCTG	28
GAGGATGAGGGACTTGTCATCCTCTGGTA	GCCGAATTGAATATGGCGCGTGAGAGTGGT	18
CAGCCAGGG	TTCCCAAAAATGC	9
TACAAATAGATCGCCAGAAAGTGGCACACACTACCGCC	AACAATTTTCAGCATCGTTTAAGGGCTTGTCTATCCCGCA	20
AGCAACGT	AACCTGGTAGAAC	9
AAGCACACCAACTGTCTATCGCCGTATCAGC	ATCTGAATCGAGAGATTTTTTATCAGCTTTTTCCT	19
CAGTCAATACTCCACTTAAACCGTTTTCGCTCACAGG	GAAATCGTAACCCCCAATTATTTTGTCGACATCCTCGA	21
CTTCTGCAGTGAAACGTCA	CGGTTTCGGCGATGATTTC	11
TACCTTCGCAACTCTGGT	CCAGACCTTCTTCCACCTCCACCC	13
TCTGCTGCGCTGCAACAACTCACCTGGACACCGGTCGATCAATCT	GGTGGCTATGCCACGATCACTAATGTTTCGAAAGAGGAGTACGGCGAA	28
GGCACCGCCAGCAGCTTTTTCGCACAGGCGAGATAAGA	CGCGTTCTCCTGTTTGTATTGTCCAAGCATCAGCAGTTCACT	22
GGACGTATACGGTGTGACG	TCAGCGATCGTTTTACGGG	10
GCAATAATTCCAGCAACCAGATTTGCACTTGACT	AGCAGATGCGCGACTTCGCTTAAGCGATCGCTGTCT	19
ACTTAAGCCTGTTTAGCCGCTTCTGCAGCTTTAACGATTAC	CATCAGTTCGGGTAAATACTCAAACATTAGCTGGGCCTCCGCT	28
TGCACGCAATTCACTCTTTGTTCAGT	CCTGTGATAAACCAGATCGAACTTCATCCGC	19
GAGGGTGTTGGAACCCGCAGCC	GGTTCGAGCTTTACCGCCGCTGGA	13
TGGCAGTTGC	TTCAGATAAGGTGATGCAA	11
TGGAAACGCCATTTAACGCTCGACGAA	GGCTGGCAGTGAGACATCGCCACTAAATTGA	19
GCAAAGCGGCCATCGGCATCTTCCTGGTCA	GTTCCAGACGCTGCATTTGCTGACTTACGGC	16
CCAAGCTGGTGAGATTCAGCAACGTGGGCGTGGGT	GACAGCAACAACAAGACGTTTGGGTGAAAACGAAAATTC	27
TGGCATGGATATGGGGATCGTC	TATTCATGGTGCCACCAGCAAGCAACGTA	16
AGCATACAAA	CAGGCAACCTG	6
T	CA	2
GAATCGTGTCGGGTGTTACTT	CATGGTCTGGCATTTTCCGTTCGTCCC	16
ATCTGCATGATGAGGATC	TACGCCACTTTTTTCTGAGC	12
CT	ATATGAGTC	8
GCAGCAACGCATAGCTTCACATAATT	TGGCGCGGATAAACCGTATTTCGATC	16
GGCATCGGGAATAGAACCATGCGCG	AACCAGACCCAAAACGATCGCTATGGCAAG	16
CGTAATGAACCAGGCATC	AACATGGTGCTGAAAGTGG	13
CGCTATCCACTTTTTTGCCCGTCCATATT	GGGCTGGGGCAATTGACACCGTTGGCGACAAAGTGCT	22
TGATCACTGGCATTTGGGTGATCACCAGATCGGCTTTGCGGTGAACC	ATGCCGTGATGCAGGAGCAAAACATTACTCGTGCCGCTCATGTTCTGGG	31
TGACGGTAAGCAACAATCTAC	CTGCTGATCGCCGTGGGCGCAC	14
ATTTATGACGACGTTAGCCTGGAAGATGCGCCGTACTTCTCAGCGC	TTATCCGGGCTTTACAGCGTTTGTGGGCTCACTTGATGACGGCGGACATCCACCG	28
CCTGACGCAATCGCGC	TGATGCGAGGCCTGTGTTTCAAT	15
CAAACTCAGCGGCAAGC	CCGTAATTCAGAAAGAGAA	11
TACGGGTTT	TCATAAAGAC	8
CAATGATTCTGACACCTGTTA	ACAACATCCATCATGCATTTAAG	12
CAAGATCGCTGACCAGGGTGAA	GCGACGCTGACGCGTCTTATCAGG	13
GAGCGTACCGGTGGAGTATCTGACACGTAAGTACCA	TACCAGTAGAGTTGATAAGCGTTGATTCTGCCCTTATTTA	22
GGCGACTTTACCTGACTCTTGCGGCAGGGTTT	CGCCCGCTGTATGTGATTGCCAGCGACGGTGGTCTGCTAC	19
AACCAGCCTCGCAATCTGGTGCTTTGCGATGATCGCC	GATTCAGGGTTTTGCCGGGGTGAGCGTGCGTGACGGTGA	23
GCTCGATAGAACTCGACAGCGCAGACTGGTTCTTGTTGATATTA	CTTCAGACTTGTATTTAGCGGCAGTTTCTTTGATCAGCTGCTGCAGTTC	26
CCGACGATCGTTATTCTCTGCTTAAGCTT	TTTTAGCTCCATTCCGTTAGCCGGTTCCG	19
CGCTTTTTG	TTTACAGTCTCC	9
TGCTTTTCCATTGCGTG	GCGTATACCCAGCCCCTTT	11
AC	GCGTCC	5
CGCCAGGAACTGGATCTCTACATCTGCCTGCGTCCGGTACGTTACTAT	CCGCTGATCTTACTTGCACCTTGTGACTTCAACCACGCTTCCGCTGCGCCAAACAA	27
AACGCCCTTCGGCAATCACCCG	CCATGATCTGGTGCGATTTGCCCGCCAA	16
GGCAGGTT	AATAACGCACTCA	10
TCA	GCGT	3
TCATGGCATTCGTTCATGG	GACGTCCGCATCGGTCATG	8
ACAATGTTCAGCAGGACGAAGATCCACAGCACCACGACGC	CGCACACCAGGCTGACCGGATCGTCCCAGTTCAGCGTAGA	22
AGTCACCTGCCCACCGCGATC	CTTAAAGAACATGGTATTAAA	16
CACCGTATACGTCCACTTTCGTGTTTGCACAGTGCTGTGTTTTTAATAAA	CGCAGACACGCAGTCACGGTAATGCCAGTCGCGAAGCATTTGAGCAGGCGTTGGGTT	32
A	GTGCCA	5
TGTTTAAATATCATCAGCTCGCGGTGACAACAATTGGCACTC	CGCGCCAACGCGCAAGGAAACTTGATTTTTAACTGCGTGGGTTGCC	30
TTGCCTGAT	CAGCGCCTGA	5
TTTTGCCAATGCCGCCAAACACATACAGATTGCCATCAATAAATGCAG	CTGGAACGACATGTTCCGGGAGAATTTTAGAAAACGGAGGCAATTCAAAGGGAGT	29
GT	TATCA	4
GATGACCTTTACCCGCGCATCGGCCAGGCATTTCG	AACTGCATTTGCGTTGATGGGCCTGTTGGCTGCCAACGGA	23
CATCAGTTCGATCCG	AAAAAGCGGTCATGCAGGC	11
TGCCAGTTTTATCTTTGGGGACGCATAA	CTATGCAGCCCATTGTTAAAACGATGGATTTCGCGCA	21
ATATCTCAGTGCAACCCTCGCAGCATGAAATCCCTT	GGAAGGGGTTCTCCTTACAATCTGTGAACTTCACCACA	23
TTAGCCCCGCG	TATTGCTGTTAAGCC	9
CCTTCAGATACCAGTACATCGCTTGCTTATAGTCCTGGTCCACCCCT	CTGGTGTACCTGGATTGATTGCTGCAAACAGCATTACTAACAGTGCTTACC	28
GAGCTGAATTAAATAACAATTA	CGTAAATCTGAATGCGCGAGGTCACGGCCGC	19
TCAAAGGTCTGAACTTTGTTGCCATTATCTCACTGATGGGTTGGGGGC	CGGAAGTCGCACACGCGGAGCTGATGGAGTAGTTAACGCCATGAATTTTAAACG	32
CCATTTAATATCGTTAATCATCCGTCGTTG	AATGAGTAACATCAAACGCGACCGCGCCGAAGGTA	20
AAA	GACGGGCTG	8
GTTAGATGCTTTTAGCTACGGCACTGTT	TCGAACCCCGGATGCAGCTTTTGACCGCATACTCCCT	21
GAATACAACATCGCCGGTGA	CTGAAAAGCTGATTCACCATCTG	13
GTTTCTTGTCATTC	GACCAAAATCGAGGCCGGTAAT	16
TATCCTGCCGGCTGAAAATGGGT	GCATCACCAGCAGCACCAGAATCAGCA	15
CAGATGGACAAATTATTAATTTTCATCTGCATCATTTCG	GCCGGACTTGCCGATCCACAGATCCAGGCGAAAGGCGATACGCTGT	29
ACCGATCTGGTGAAAAAAGGTAGCCGTTTCTGGAACGTTTCCGGCGTTG	GATGACCCGGGATATTCCAGTGGTGATGTTGACCGCCAGAGGGGAAGAA	30
TCGGCGCGGCGAGGCGAGCTTTTTGTAAAATCCGATGCCATTGC	AACATTTGCACTGCCGGGAGTGTAATCCTGAGTCGCAAATACCCGCAGACAT	29
G	TAACGTAG	7
TATCAGACAGATAAGCAGCCCTGGCAGAAATTTCAGCAGATTTC	GTGTATCAAACAAGACGATTAAAAATCTTCGTTAGTTTCTGCTACGC	26
TAATTCCGCAAGCCTGACAAAATCAAAGTGAATAAAAATGCAATAT	GGCACCTGCGCCGATGCCGCGTCAGACTGATACCCGTACCGTAGAA	28
TCGCTTACC	TCAAACAGTTCGC	7
CACTCTGCTGTAATGTAAAACCTTCCAGTTGTTC	ACTAATGCGCCAAACATTTATTGCGCGTAAAATATCGTTT	21
AACGGTATGGTACTTAGCCCCAACAGA	TTTCGGTTTCCCGCACTTTGGTGCGTAG	16
CAGCTCTT	GGCATCGCGACG	8
GCAACCATCTGACAGAA	AATAAAATAGCGTCGCTG	13
GATAAAGCCCGTAGCCGTAAAATGGCGTGGTTCGCCAACCAGCGTGAG	CGGGCATTATCGTGGCGGCGGATATTCGCGGTGCCGATGCCAACAACGCTGGG	24
GGGCAGGCGTGCTTTATCGGCTACGGTGGGATGT	CTGATGAGGTTTTTGTCCGTCATTCTGGCAACGGCGG	21
GGCGAATA	GGGTGGAG	5
TTTCGCA	TTATACTCGA	4
AG	AAAGGCC	5
CCCTTAACGATTTATGGTCCGCAAGGTATCCGTGAATTTGTG	ATGCCCTGAATACCGAGCGGAATATCCACCTCTTGATTGAGATTGTC	26
ATAAGCC	CGCATACTTATACA	9
ACACGATCTTCATGCTGCAATGAACAACATTCA	TCCGACGGTCTGAACATGAACGGCAAGAATGGTCT	18
ATCA	CCCGC	4
GAACGGCTGC	CCGCCATGAAGG	9
CGACGCGGCTGAAGGTAAAAA	CAGATGCTGATTATGATACCGAAAACGG	13
GCTGGATTTCGCCCGGTTTGCGAGTTTTCAGCAATTTTAGTATCCAGG	CGCAAAATTATTTGTCGTTATGATTTAAATGTTTTGTTTTACACTCTGTCAA	30
TAAAAAAACCTGATACCGAACAACTTAACTTGCTTAAAAAATCACA	CAAATTCATACCGCACAGGATAACCACGACGGCGTACTACGCGTGG	27
C	GTTGT	5
AACAGGCACAAAAACGTCTGAACGCGATGTA	CAATGGCGCGATAACCGGCGATGTTCGCCATCG	16
TTGATGCCATCTAC	AGTGATGATGGTTTCGGGTTTGC	13
TAAATTAAGCAGCGGTTTT	ACTGACCGAGCGCGATATTA	11
TTAAT	CGACGTTGCCTGCT	11
GGGAATTTACTGG	TTCCGCGATGTGGAAG	11
TTTTAGAAAAG	AGCGCACTAAG	8
CAACCAGAATCAGCAATATCGGCAGAATCATCACCCGCCAGCGCGCCCA	GACTCGGTCCATAGCTTTATTCGGGAAGGCGAAAGCAAAGGGCAACTGTT	30
AAATAGCGGAAGTACAGGCTACGCCACGCTGAATTATC	GGCGCTGGGCCACAGTACATAATTTTTCGACGATATGCGGCGGA	28
AGAAAACCTGGTTGTTGTTAACAGTCTAACCGGTCAAT	AACTGCGGAAAAAAACAGCAAAACCGATGTGTTCGCTGAGAAAAAAG	31
AACATTGACCGCGGATGCACGGTCAATATTTCTACAAAAAGG	GCATCCACTTCATACAAAATGCCGGAAGAGGTACGCGTACTGAACA	27
GGTGCTGGCGCAGACCGCGGGTGGTCTGTCCTGCTTT	ATTGTCGATGAGCCGACGCGCGGCGTGGATGTCTCGGCCCGTAA	19
TAGCGGTATTTCTTAAGTGAGTACTGCT	TTTATCCCGATCTTCACCCTGGAAGGGCAG	18
AGGACGATCCGATTCC	AGCATCAGATACTCGCCAGTAATGC	11
TATTTCTCGGCGCGG	CATCTTCTTCACGTCC	8
CAGAATTTCTGGG	GAGTGATGTGCTCTAACCA	11
GAGAGAAACTATGTTTGAAC	GCGTAGTCGTCCCACTGCACA	13
ATAAATGGTCATCACCATCATCCGG	AGCAACTCGCCAATAACAATCCGCGATTC	15
C	CCGAAGCAGG	9
ACAGCGAATTAAAAGAGGA	CGTTTAGATCGAGTTTGGACATAGATT	16
AGCATAATGTCCTGCACCATCTGCGGCATACTTTCGCGCGGCGTGGAACC	GCAAGGCAGCCAGTGCATTTTCTCGTCAGGCTGAGATGTTCGATACCACT	29
GTGTCTGCTCATTGGTGTCTCC	CGCTGGCGGTTATCGCACCGTCGCCGCCCAG	17
ACTCACAACTACGTGGTCTGCTTTCTTGTCGCCTAAGTTTATTGAGTTAT	CTTGACCCGAAAGGCGGGAAAGCGCCTGCCGATAAGTTGTGATAAGACAATAATTCAC	32
G	TGCACTCT	7
GCCTGGTTGAGCAGCGTAATCGCCCGCTGGGAGACTTTTTTCGC	ACTCGTCTGCAAGGCTGGTTTATCCCTTCTTCGACGGGCCCTGC	25
GGCGCGGTATATTCCAAAGAGCTTTTAATGGAGATTGTG	CTGATACTGGATCCATGCTCGTTCCGCTTGTTCTTCGATG	24
CCAG	ATCGA	4
CTAAC	TACTGAACACT	6
AGCCCCATAGTATAAC	GTGCATTTCGGTCTGTAGCGGTAC	15
A	TGTAA	4
GCACAAC	TGCCATAACGGAAA	8
CCCGGTAGATAATGACTTTGCCCGATGTAG	GCGATAGCTATAACGCTTGTCTGGCAAAGGCATACGCGT	20
TAAATAGATTAGAAACATTTTGATATCTTTTAAATACA	AAGCGGGGAAATTCTTCTCGGCTGACTCAGTCATTTCAT	24
GCGACGAATCGCTTCTTCCAGGTTGGCGCACAGTTTGCGAT	AAGGATTGAGTTGTTTTACTTGAATTAATACACCAGCGAGCTCTGATA	26
TTTTCTTCTGCGCGGTTAGGCGTGAAGGCCC	GTTAGGCTTAATACCCGATTGCGGTGGAACCTGGTTACTG	21
GTCCACCACGTTATTTAAAGATTTCACCTTCGAAGCCGCTCACCGCTTA	TCGTCAGTCCGTTGCTCGCACCGCTAATCGGCGGTCTGCTGGATACGATGTGGAACTG	35
ATCAACAGCATTTGCGGGTCTTTAGCGCAAACCTGATTCAGT	CAGATGCTCAAAGAGATGGGCACCGGGCTGGTGGTGACGGAATTGATGGG	28
TCCTAACCCAAACATGCGTCCGG	CCTAATACACCGGCGGTTTTCTTCGCCGC	16
TTGTTACGTTTCGCCTCTACCACCGCGATGGGTTTG	ATTGATTTCCTGCCATCGGAATTGCACTGGCTGGACGTCTT	21
TTGGGTCAGGAAGTGTGGAAAGAGGGCGATAAGAGCTTCTATT	TCACCAGACTGACGCCCGCCGCAATCAACTCCTGCGGCATTGGCTCTTTC	31
AAGTCGACCGCCTGGGGAGTACGGCCGCAAGGTTAAAACTCAAATGAA	CCTGATAAGACGCGCAAGCGTCGCATCAGGCAACCAGTGCCGGATGCGGC	31
GCCTGTCATC	TCGTTTGACT	6
CTTTCAGTCA	TCTCTTTACCGATGGT	9
CCTCGACCATTTCGTTTAACCTGCCGACC	TCTGTTCACTGGCTGAAACCAGCACGTTATT	16
TCTAGGATAAAAAGGAATGTAACAATCTCATGGCGTAAGCTGACGAAT	CTATATTATCAACAAGACCAGACACTTATAGAATTAGTGATGATTTATTCACT	29
CTTATCGATCAGGGCGTTAAACAAGTATTCGGTTATCCC	TAACGTTGTTGACGCGAACCGCCATGTAAATGCTGAGTGAGCGA	24
TATGTTTGAACCAGATATCGCGGATATGCAGCAGCCAGTTGTTGAT	ACAAACCGATGCCCGCCGCCAGAGCAATAGCGATAGCCACCGCGCT	28
ATCATGCTTGATAAAGGCCGCCTGCATGGGGTG	TATTTGCACCTCAGGCATGGTTAAAATACAAAGATGCAAA	25
GCTCCTGCCGCGAAAGATCGCTGGCGC	TTAAAACCTGTCAATGTCGGAACTACG	17
CGAAAGGTGAAACTCAGCTGACCCCAGAAGAAAAACTGCTGCGTGCGA	TTACTGTTCAATAATCACCTTCCATCAATACTAAAATTAATACCCCTAATG	28
TGC	CCGTGATGCATG	9
CCACTGCCGTCAGACCGGTACGACCGCCAACCGATACGCCG	GCTGGAGAAAAATACGCTACGCCCGGAGATGAGCAGCGACGAAATTGA	27
CTGCAAAATTT	CACTTGGCATTGCT	9
CCCAAAAAGCCGGGGATTTTTTATATCTGCGTTC	AGGGCAGCGAATTCGTGATGTTCGCACTGGACCCGACGG	24
CTCAAACGCAATATCCGTCACTGAATAGTTGGTCATTTCCAGTTG	CCCAGATTGCCGATATAAACCATCGGCGCTGGCGTGCGGCGTAATGCCTGGG	27
TCTCCTTTATACAACAGCAGCCTATGATGACGGCTGAAACAGGG	GCACGTTGGTCACGGCGTCAACGCCGGGCGCAGATATGACGCCCGG	25
TCTGATGG	AAAAATGCGCCCGTT	11
TAAACGGCGAGGAAGGAGATGCCAGCTTTTGAA	AAAACAAGCGTATGGCAATCTTCTTTATCTTCTCAATG	19
ACGTTGTCTGACCAGCGCGTTAACTTCGGTTTTTCAT	ATATAAAAACATTCATTTTTTTAAATGTTCCGTGTCGGGTACTG	27
ATAATCCTGAACGTTATGCTGAA	ACTAAATGGTGCAATCATTTTCACAT	12
CTGTGGCTGGA	CCGTCTCGTTCTGAC	8
AACGCCAGCAAAGCCGG	GCTCTTCGGCGTATTATCGCT	14
CCGTTAACGG	CTGTTCAGCATGGT	6
GAAAGCTGCTGGCGCTAACAAAGTTGCTGTTA	TGAGCCGCAAAAACTGGCTGCGGCGCTGTTACCGCTGT	21
CGCCAAATTAGATCACCTGCCACGCGATTTCCGT	TGCCGGAACAGTTCCCTGCTCTTTAAAGGTTTACC	18
ATGGCTTACAGCCGTGT	CGCGATGCATTGCGTGCGGCGCTG	13
AGCCTGACTAAATATCCGTTTGGTCGTTACCGGCTTTAGCAA	TTGCATTCCCTGGGCCGTCATGCGGATAATTTCCATTTCCCG	27
TCGTTATTTACGTGCATGATGGACACGAGGATGGTGTCGTCACGCA	GCAGGCGGTTATCTCTGGCGTCTTCTCATTGACGCGTCAGGCGGTA	28
A	AATCGGGGCG	9
CGGCGGTTGACGCCCCTGGCGATGCCCCCAGGAGCGCGGCAATGGTT	TTATCTACCGTCAATTTTTTACCCGCTGAAAACCAGGTAGCCGACTG	31
GCG	TAA	3
CGCGCGGACCGATAAAGACTATTTGAAATTGCTCGATACTCGCCCG	ATAGTTGAAATTCCCCTGCCACCTGGCAAAATATCCGTTCAACCATCAGC	32
TAACACGTCGTTCAAGT	TAAATCGCCACCAGACAAG	10
CTCGGTAACGGCAACAGTTT	CAAGATAAACGCGCGACCAGGCAATG	12
GACTGATTTCGATTTCATGCCATTGGATAAATG	ATTTTTTATCACGGCTTTACTTCATCCAGTCTGGT	22
TTGCCGAACTGGATTTCTGTCTCGCTTTGGCGTGAGTGGGTTGAATT	GCAAGCCTGGCAGCCTACGCACAAGGTCGAGTCGTACAACATCCCCAGCGATCCCG	37
CTGACCACATAGTCTG	GATTTCCCTCAAATGTT	10
AAGTCGCGCTGGAAAAAGGTTGGGATGAATATAAGCAACGCTGGC	GCGGCGATGGTACGTGAAAACGTCATTGCTCAGTTGGCTAATTTGCAAAC	28
AAATCCGCTCTGGTTTTGCTGCA	GTTGCGGGCAGAGATATCGCGCAATA	15
GAGCGCGTAATTTTT	CCCTGGCAATTGCGCCTGTTCGG	15
GGT	TTAAGCTTTTT	9
TCTTCCGTCTGGATCATCCAGCCCAG	ATGTTTTGCTTTGACAATCCCCTGGTGTT	17
TACCCATATGACCGCCTTCGCCCGCGTGCGGATTCAGCCCGCAGACC	TGGCAACGGGTGGTGGCGACATTTCGCAAGCGGAAGTGCTGTTGAAACG	28
AAAGTTCCAGAAAGCGCCAGACATAGTTACGC	ACAAAAACATCGCGGGTGTTGAAGAAAAATTAACCTATA	24
TCGAAAACGATCTTACCGGGCCGTTTATGCCGCATGGTATCGGCCATC	GGGGCGTAAAATTTCTGTCGATTCGGCTACCATGATGAACAAAGGTCTGG	29
CAATTGTGGATCAATATAGTCACTGTGAATGG	AGGTTTTATTATCGCTCAGGATTATGGTCACC	21
TGACCATTCTGGTGGGGAACTCCGGCGACCGCAGCA	CCGCGGTACACGTCAAATAAGTTTACGCCAACTACCTGAT	25
AGAAGTGGCGAGCGAATA	GATCAGCGATTTGCCGTCAAAG	13
GTCGGCAAACTGCTGCGTCAACTC	GAGAGCTTAAATCGGGCGATGCTTGCATT	15
TTTATGCGTCGACTGGGC	AGGCGAAAACCTGTTTGAAGTGAAA	17
CCATTTTGTATTGGACAGGTAC	CATTTTGGAAGCGGCGACCATCTCCAT	13
TCCTACAGAAA	CATATCAATACTTGTACAG	11
GTGCATTAATGTTTGCTTTAGTCGTCA	CAGCGCCCACATCACGGTCATGGTAACGCCCT	20
AGACGACGGGTCAGG	GACATACAGTGGATCGA	8
TACGCTCGCAC	AAATACGCTACGCCCGGA	8
CC	GTTGCTCG	6
CACCTTTATATTGTGGGAGATAGCCCTGATATCCGTGTGTCGATTTGGG	GCTGTTACTTTCACAATGCCCGGAATGCAAGCCGTATATTCGCCGTCTGGTGATCATG	28
CATAATCAACACCCGGCGACC	GGCTTTCTGTCACTTCCAGAATCA	15
CAGCCGTAATGATATTTTTTACGGTGATGTAATTATTTACCGC	GGTGTTTGCCACCGTTGGTTCTGGCCCTGGGGGTAACGGGCAAAACGTGG	32
GCGCGG	CCGCGAC	3
CTTTCT	TTACCGCCGCGC	10
ATGTAGCGGAAATAGAGCAGACGATTCTCTCTTTTGTCGATGCCTG	TCGCTGATACCATTACAAAGACAAACGTACATAGAGACTCCCGTATACTT	28
AACGGTTAGGGCGAGCAGCACTTCC	TTCCTTAATGATTGTTTTACCCAGACGCC	18
CACTGGTTATCAGTAATTTGCCGGAGCG	CATCGCAGTAGCGTGCAGTAAAATCTTTC	18
CAAACGCGTACCGACAAACGCAC	CAAAATGCATCATACATTTACTGAATCT	13
TAAACCGTGGCCTTACGATCCAGTGAAA	TGCCGTCAGCTGCGTTCTGCACTGTTATTTCATGA	20
CTACATTTAATAAA	CGTCTTTATCTTCA	7
TTGGTGAGAGATGCCAGATAATCCACCAGTTGCTGCACGCTTTGCG	AGAGCCGGTTTTGGTTTTCTGTCTTAACGCACCATGCACGGGCGCTTGTTATCGA	30
CT	TTCAATTGTGG	9
CCTGCGGGCAAAGACATCCGCGAG	CGGTCGGTTCCGGAGCAGCCGAATGAT	14
GATGAAGCTGACGGTCAGT	TCACGCTTTGCGACATCCAG	12
ATTGATTTAAATCACATTAACCAGGA	TCGCCGCAGGACAGTTTAGGCACCCGTAGTAAAGC	22
AAAATAT	TAATCTC	4
TTCCATTCTGCCCATGTTCAGCCGGTATTTGCCGTGCTCGA	AAGAGCAGCCCGGACGATCGGTTAGATCAGGCGCTAAAAGAGCT	27
ATTGGTC	AGACCTAATT	7
GCTGCCACAATGAACGCGCCTGTGCTGCGTCAA	AAACGATCATTGTCATTTGACCAGGCGCAGAGCTTTACG	23
TATTCGTGCGGGCATGTATACCACTGTGCAGGATGGCGGTCGTCACGGT	TGTTCGGTTGTAAAACGTTCAGAAGCAGCGGTATAAAGTGCTCATCCTCA	29
AGCAAAGATGCCACCCCGGGCA	TCTGCGTAATACTTTGCTATTTCAACAG	17
CGCTCAGGTACTGGTGTTTAATGGCTTCTACGA	AAGTGTTACTGACTCTCAAATAAAATTTAAATCAAACAA	23
TGCTGAAATACCGGTGCGTC	GCAACGCTCGAATTTTTAAAACAGTG	16
CAC	TGTTGACCCGCG	10
AATCTGCTCTGGCAGCACTACGCAGAAAAATCCCTCT	GAGCACCTAATGCCGGATGCGTCGTGAACGCCTTATCC	21
ATCCCAATAATCACGGTGGCGGTATTCACGGGGAG	AGATTTACCGATTGGCTTGCTGACGAACTGGCGTG	20
CAGGCCTGGAGGTGGCAATTACTGCCCACACACCTCAC	CTCGCGCATACAGCCGGGCAGTGACGTCATCGTCTGCGC	20
CCTGAGTATAAAATCTCTTCTGATGTTTAATTGATTTGAATGTTCGT	GTAGACGGCAAACCGGCTGCAGGCGGTATGTTGTTGCAGGTAATGCCTG	28
CAAATGCCC	TCATGACGCCGGAAC	8
GCAACGGTGAAAGAGGTGCATGACGCGCCAGCGGTGCG	CCCGACCTATAACGACCGGCTCAAGATCATCATCACTTTTCAGAA	25
TTAATTTCACCGGCA	CCTCAGCTGCCATTCCGGTT	11
GCGAATATCTACCAGAAAAGTACTGGCGAGCGCCT	AGATTTAAGCAAGCATTTATTTGGAATGTATTTTTCGTTCGAC	24
AGGCAT	TTTACCGCC	7
CATTGTACCTATGCAGGAAGTTTTGCCGCTCCTGACGGAATACATTGA	AGTCGGTTCCCGCTTCCCACTGCTTGGCGAGCTGCAAAGCATACTCAAACAAGCCGT	33
AACGATCGACTCCGCTTTCCCCGCTTTGCC	GAGTATCTGGTGACGGTCGATAAACCGATTACCGAGG	22
ACACCGTGGGAACCGTCCTGAACGCCCACC	TTTTGTACGTTCTGCACTATGCGATGAAGGAT	22
TAAAGCAGAAAAAACCTATCAAAATACCGTTGCATTGACGCCAGAAGATG	CACCACGCTCTTTGGCTGCCGTAACGTCAATCTGGACTGATATCATGAAACG	31
GAAACCGAATATTGGGTTTAGTCTTGTTTCATAATTGTTGCA	ATATTTAAGTGCAAAAATATTCAGAGCCATGCTTTTTGCGTGGCT	27
CGTGTT	TTGGTCCAGCCC	9
GTGATCCCAA	TTTTGGTTATTTGTTGAG	13
TGATCAGAATG	CACGTTCAATG	6
GGAAATCGTTCG	TGATTATTTAGC	7
GAAAACAGGACTCTTTTTGAGTCA	GGGATCGCCCAGACCAAAACGCTGGCTAAGC	19
CGCAGGCAAAAGGCGCACACTAAAGTC	TTGAAAAACAAGAAAGGTGTTGTAACAGAAATACAA	20
GCGTCCGGCTGCCAGCCAGGATATGCGCCTTTCGCTTCGGTTTT	AAAACTCCAGCGCAGCTCCTTCAACACGGTCCATGGCGACATCCAGGTCAAAA	30
CTTTATCCAGTGAGTCCCCGGCAGCCGCCTGCGCCGCTGCCTGACGTTCC	CGGAACAATTTGAAAACAAGAACCTCGCTTAGGCCTGTGTCCATATTACGTGGGTA	31
ACTCAAGTGCAGTTTGCCAGTTACGCTTGTTGCCCTGATTTTC	AGTGGTATCGATTCGCACATCGCTGAACACCGAATCGAGCTGGGCGGCGA	30
GCATTATCGCGGGCGATAACCCGGATGCGGCGCTGG	TCAGACGGGTGACCAGCATGGCGACATTGAGAAGAA	22
CTCATGTATATGTCATCTC	CGACGTGAATGGTGAGTTTACTGTGCT	14
TT	CCGTTACA	6
GTGTTCCTTTGACTCTGA	GCGAGCTCGTTACCAACCTGC	11
